state_name,combined_fips,county_name,votes_gop,votes_dem,total_votes,diff,per_gop,per_dem,per_point_diff
Alabama,1001 ,Autauga County,19838,7503,27770,12335,0.714368023,0.270183651,0.444184372
Alabama,1003 ,Baldwin County,83544,24578,109679,58966,0.761713728,0.2240903,0.537623428
Alabama,1005 ,Barbour County,5622,4816,10518,806,0.534512265,0.457881727,0.076630538
Alabama,1007 ,Bibb County,7525,1986,9595,5539,0.784262637,0.206982804,0.577279833
Alabama,1009 ,Blount County,24711,2640,27588,22071,0.895715528,0.09569378,0.800021749
Alabama,1011 ,Bullock County,1146,3446,4613,-2300,0.248428355,0.747019293,-0.498590939
Alabama,1013 ,Butler County,5458,3965,9488,1493,0.575252951,0.41789629,0.157356661
Alabama,1015 ,Calhoun County,35101,15216,50983,19885,0.688484397,0.298452425,0.390031971
Alabama,1017 ,Chambers County,8753,6365,15284,2388,0.572690395,0.416448574,0.156241822
Alabama,1019 ,Cherokee County,10583,1624,12301,8959,0.860336558,0.132021787,0.728314771
Alabama,1021 ,Chilton County,16085,3073,19310,13012,0.832988089,0.159140342,0.673847747
Alabama,1023 ,Choctaw County,4296,3127,7464,1169,0.575562701,0.418944266,0.156618435
Alabama,1025 ,Clarke County,7324,5755,13135,1569,0.557594214,0.438142368,0.119451846
Alabama,1027 ,Clay County,5601,1267,6930,4334,0.808225108,0.182828283,0.625396825
Alabama,1029 ,Cleburne County,6484,675,7227,5809,0.897191089,0.093399751,0.803791338
Alabama,1031 ,Coffee County,16899,5076,22275,11823,0.758653199,0.227878788,0.530774411
Alabama,1033 ,Colbert County,19203,8343,27886,10860,0.688625117,0.299182385,0.389442731
Alabama,1035 ,Conecuh County,3442,2966,6441,476,0.53438907,0.460487502,0.073901568
Alabama,1037 ,Coosa County,3631,1796,5479,1835,0.662712174,0.327797043,0.33491513
Alabama,1039 ,Covington County,14586,2721,17430,11865,0.836833046,0.156110155,0.680722892
Alabama,1041 ,Crenshaw County,4864,1700,6617,3164,0.735076319,0.256914009,0.478162309
Alabama,1043 ,Cullman County,36880,4478,41851,32402,0.881221476,0.106998638,0.774222838
Alabama,1045 ,Dale County,14303,5170,19738,9133,0.724642821,0.2619313,0.462711521
Alabama,1047 ,Dallas County,5524,12230,17864,-6706,0.309225258,0.684617107,-0.37539185
Alabama,1049 ,DeKalb County,24767,4281,29356,20486,0.843677613,0.145830495,0.697847118
Alabama,1051 ,Elmore County,30164,10367,41030,19797,0.735169388,0.252668779,0.482500609
Alabama,1053 ,Escambia County,10869,4918,15910,5951,0.683155248,0.309113765,0.374041483
Alabama,1055 ,Etowah County,35528,11567,47728,23961,0.744384847,0.242352497,0.50203235
Alabama,1057 ,Fayette County,7300,1395,8766,5905,0.832762948,0.159137577,0.673625371
Alabama,1059 ,Franklin County,10376,2086,12578,8290,0.824932422,0.165845126,0.659087295
Alabama,1061 ,Geneva County,10848,1595,12545,9253,0.864726983,0.127142288,0.737584695
Alabama,1063 ,Greene County,875,3884,4775,-3009,0.183246073,0.813403141,-0.630157068
Alabama,1065 ,Hale County,3192,4663,7900,-1471,0.404050633,0.590253165,-0.186202532
Alabama,1067 ,Henry County,6607,2606,9298,4001,0.710582921,0.280275328,0.430307593
Alabama,1069 ,Houston County,32618,12917,46173,19701,0.706430165,0.279752236,0.426677929
Alabama,1071 ,Jackson County,19670,3717,23636,15953,0.832205111,0.157260112,0.674944999
Alabama,1073 ,Jefferson County,138843,181688,325848,-42845,0.426097444,0.557585132,-0.131487688
Alabama,1075 ,Lamar County,6174,978,7193,5196,0.858334492,0.135965522,0.72236897
Alabama,1077 ,Lauderdale County,31721,11915,44339,19806,0.715419834,0.26872505,0.446694783
Alabama,1079 ,Lawrence County,12322,3562,16031,8760,0.768635768,0.222194498,0.54644127
Alabama,1081 ,Lee County,42221,27860,71449,14361,0.590924995,0.38992848,0.200996515
Alabama,1083 ,Limestone County,34640,13672,49235,20968,0.703564537,0.277688636,0.425875901
Alabama,1085 ,Lowndes County,1836,4972,6835,-3136,0.26861741,0.727432334,-0.458814923
Alabama,1087 ,Macon County,1541,7108,8723,-5567,0.176659406,0.814857274,-0.638197868
Alabama,1089 ,Madison County,102780,87286,194767,15494,0.527707466,0.448156002,0.079551464
Alabama,1091 ,Marengo County,5343,5488,10900,-145,0.490183486,0.503486239,-0.013302752
Alabama,1093 ,Marion County,12205,1463,13807,10742,0.883971898,0.105960745,0.778011154
Alabama,1095 ,Marshall County,33191,5943,39655,27248,0.836994074,0.149867608,0.687126466
Alabama,1097 ,Mobile County,101243,79474,183164,21769,0.552745081,0.433895307,0.118849774
Alabama,1099 ,Monroe County,6147,4455,10668,1692,0.576209224,0.417604049,0.158605174
Alabama,1101 ,Montgomery County,33311,64529,99139,-31218,0.336002986,0.650894199,-0.314891213
Alabama,1103 ,Morgan County,39664,13234,53722,26430,0.738319497,0.246342281,0.491977216
Alabama,1105 ,Perry County,1339,3860,5230,-2521,0.256022945,0.738049713,-0.482026769
Alabama,1107 ,Pickens County,5594,4022,9668,1572,0.578609847,0.416011585,0.162598262
Alabama,1109 ,Pike County,8042,5636,13841,2406,0.581027382,0.407196012,0.173831371
Alabama,1111 ,Randolph County,8559,2203,10837,6356,0.789794223,0.203285042,0.586509182
Alabama,1113 ,Russell County,9864,11228,21329,-1364,0.462468939,0.526419429,-0.06395049
Alabama,1115 ,St. Clair County,36166,7744,44441,28422,0.813798069,0.174253505,0.639544565
Alabama,1117 ,Shelby County,79700,33268,114950,46432,0.693344933,0.289412788,0.403932144
Alabama,1119 ,Sumter County,1598,4648,6291,-3050,0.25401367,0.738833254,-0.484819584
Alabama,1121 ,Talladega County,22235,13138,35663,9097,0.623475311,0.368393012,0.255082298
Alabama,1123 ,Tallapoosa County,14963,5859,20991,9104,0.712829308,0.279119623,0.433709685
Alabama,1125 ,Tuscaloosa County,51117,37765,90172,13352,0.56688329,0.418810717,0.148072572
Alabama,1127 ,Walker County,26002,4834,31170,21168,0.834199551,0.155085018,0.679114533
Alabama,1129 ,Washington County,6564,2258,8876,4306,0.739522307,0.254393871,0.485128436
Alabama,1131 ,Wilcox County,1833,4048,5903,-2215,0.310520075,0.685753007,-0.375232932
Alabama,1133 ,Winston County,10195,974,11284,9221,0.90349167,0.086316909,0.817174761
Alaska,2901 ,District 1,3509,3476,7311,33,0.479961702,0.475447955,0.004513746
Alaska,2902 ,District 2,3671,2102,6131,1569,0.598760398,0.342847823,0.255912575
Alaska,2903 ,District 3,6070,1902,8375,4168,0.724776119,0.227104478,0.497671642
Alaska,2904 ,District 4,4687,5347,10585,-660,0.44279641,0.505148795,-0.062352385
Alaska,2905 ,District 5,4077,4203,8653,-126,0.47116607,0.485727493,-0.014561424
Alaska,2906 ,District 6,5750,3264,9430,2486,0.609756098,0.346129374,0.263626723
Alaska,2907 ,District 7,7023,2212,9614,4811,0.730497192,0.230081132,0.50041606
Alaska,2908 ,District 8,7590,1952,9883,5638,0.76798543,0.197510877,0.570474552
Alaska,2909 ,District 9,7781,2768,10986,5013,0.708265065,0.251957036,0.456308028
Alaska,2910 ,District 10,8069,2724,11190,5345,0.721090259,0.243431635,0.477658624
Alaska,2911 ,District 11,7092,3129,10623,3963,0.66760802,0.294549562,0.373058458
Alaska,2912 ,District 12,7871,2954,11213,4917,0.70195309,0.263444217,0.438508874
Alaska,2913 ,District 13,4649,2663,7707,1986,0.603217854,0.345530038,0.257687816
Alaska,2914 ,District 14,6711,4260,11437,2451,0.58677975,0.372475299,0.21430445
Alaska,2915 ,District 15,2658,2614,5538,44,0.479956663,0.472011557,0.007945107
Alaska,2916 ,District 16,3519,4273,8121,-754,0.43332102,0.526166728,-0.092845709
Alaska,2917 ,District 17,2774,4095,7159,-1321,0.387484286,0.572007264,-0.184522978
Alaska,2918 ,District 18,2754,4679,7711,-1925,0.35715212,0.606795487,-0.249643367
Alaska,2919 ,District 19,1971,3115,5294,-1144,0.372308274,0.588401964,-0.216093691
Alaska,2920 ,District 20,2350,4834,7410,-2484,0.317139001,0.652361673,-0.335222672
Alaska,2921 ,District 21,3685,5409,9419,-1724,0.391230492,0.574264784,-0.183034292
Alaska,2922 ,District 22,4662,4541,9484,121,0.491564741,0.478806411,0.01275833
Alaska,2923 ,District 23,3636,3796,7705,-160,0.471901363,0.492667099,-0.020765737
Alaska,2924 ,District 24,5374,4734,10422,640,0.515639992,0.454231434,0.061408559
Alaska,2925 ,District 25,4385,4592,9294,-207,0.47180977,0.494082204,-0.022272434
Alaska,2926 ,District 26,5241,4557,10108,684,0.518500198,0.450831025,0.067669173
Alaska,2927 ,District 27,4319,4843,9499,-524,0.45467944,0.509843141,-0.055163701
Alaska,2928 ,District 28,6154,6259,12736,-105,0.483197236,0.491441583,-0.008244347
Alaska,2929 ,District 29,7455,2984,10737,4471,0.694328025,0.277917482,0.416410543
Alaska,2930 ,District 30,7182,2637,10177,4545,0.705708952,0.259113688,0.446595264
Alaska,2931 ,District 31,6956,5032,12389,1924,0.561465816,0.406166761,0.155299056
Alaska,2932 ,District 32,4429,3496,8313,933,0.532779983,0.420546133,0.112233851
Alaska,2933 ,District 33,3058,7534,10952,-4476,0.279218408,0.687910884,-0.408692476
Alaska,2934 ,District 34,4542,5762,10727,-1220,0.423417545,0.53714925,-0.113731705
Alaska,2935 ,District 35,4768,5010,10100,-242,0.472079208,0.496039604,-0.023960396
Alaska,2936 ,District 36,5112,3795,9289,1317,0.550328345,0.408547745,0.141780601
Alaska,2937 ,District 37,2324,2522,5066,-198,0.458744572,0.497828662,-0.03908409
Alaska,2938 ,District 38,1737,3202,5299,-1465,0.327797698,0.604264956,-0.276467258
Alaska,2939 ,District 39,1896,3550,5811,-1654,0.326277749,0.610910342,-0.284632593
Alaska,2940 ,District 40,1993,2308,4590,-315,0.434204793,0.502832244,-0.068627451
Arizona,4001 ,Apache County,11442,23293,35172,-11851,0.325315592,0.662259752,-0.33694416
Arizona,4003 ,Cochise County,35557,23732,60442,11825,0.588282982,0.392640879,0.195642103
Arizona,4005 ,Coconino County,27052,44698,73272,-17646,0.369199694,0.610028387,-0.240828693
Arizona,4007 ,Gila County,18377,8943,27662,9434,0.664340973,0.323295496,0.341045478
Arizona,4009 ,Graham County,10749,4034,14995,6715,0.716838946,0.269023008,0.447815939
Arizona,4011 ,Greenlee County,2433,1182,3685,1251,0.660244233,0.320759837,0.339484396
Arizona,4012 ,La Paz County,5129,2236,7458,2893,0.687717887,0.299812282,0.387905605
Arizona,4013 ,Maricopa County,995665,1040774,2068144,-45109,0.481429243,0.503240587,-0.021811344
Arizona,4015 ,Mohave County,78535,24831,104668,53704,0.750324837,0.237235831,0.513089005
Arizona,4017 ,Navajo County,27657,23383,51767,4274,0.534259277,0.451697027,0.08256225
Arizona,4019 ,Pima County,207758,304981,520397,-97223,0.399229819,0.586054493,-0.186824674
Arizona,4021 ,Pinal County,107077,75106,185525,31971,0.577156717,0.404829538,0.17232718
Arizona,4023 ,Santa Cruz County,6194,13138,19556,-6944,0.316731438,0.671814277,-0.355082839
Arizona,4025 ,Yavapai County,91527,49602,143221,41925,0.639061311,0.346331893,0.292729418
Arizona,4027 ,Yuma County,36534,32210,69881,4324,0.522803051,0.460926432,0.061876619
Arkansas,5001 ,Arkansas County,4304,1818,6292,2486,0.684043229,0.288938334,0.395104895
Arkansas,5003 ,Ashley County,5548,2125,7926,3423,0.699974767,0.268104971,0.431869796
Arkansas,5005 ,Baxter County,15836,4635,21007,11201,0.753843957,0.220640739,0.533203218
Arkansas,5007 ,Benton County,73965,42249,119912,31716,0.61682734,0.352333378,0.264493962
Arkansas,5009 ,Boone County,13652,3064,17114,10588,0.797709478,0.179034708,0.618674769
Arkansas,5011 ,Bradley County,2335,1214,3654,1121,0.639025725,0.332238643,0.306787083
Arkansas,5013 ,Calhoun County,1636,479,2182,1157,0.749770852,0.219523373,0.530247479
Arkansas,5015 ,Carroll County,7424,4023,11797,3401,0.629312537,0.341018903,0.288293634
Arkansas,5017 ,Chicot County,1752,2260,4103,-508,0.427004631,0.550816476,-0.123811845
Arkansas,5019 ,Clark County,4616,3438,8395,1178,0.549851102,0.409529482,0.14032162
Arkansas,5021 ,Clay County,4086,962,5183,3124,0.788346517,0.185606791,0.602739726
Arkansas,5023 ,Cleburne County,10328,1988,12680,8340,0.814511041,0.156782334,0.657728707
Arkansas,5025 ,Cleveland County,2867,651,3600,2216,0.796388889,0.180833333,0.615555556
Arkansas,5027 ,Columbia County,5500,2814,8616,2686,0.638347261,0.326601671,0.31174559
Arkansas,5029 ,Conway County,5694,2615,8685,3079,0.655613126,0.30109384,0.354519286
Arkansas,5031 ,Craighead County,25558,11921,38511,13637,0.66365454,0.309547921,0.354106619
Arkansas,5033 ,Crawford County,18607,4959,24091,13648,0.772363123,0.205844506,0.566518617
Arkansas,5035 ,Crittenden County,7333,8514,16367,-1181,0.448035682,0.520193071,-0.07215739
Arkansas,5037 ,Cross County,4946,1772,6942,3174,0.712474791,0.255257851,0.45721694
Arkansas,5039 ,Dallas County,1573,963,2649,610,0.593808985,0.363533409,0.230275576
Arkansas,5041 ,Desha County,1921,2016,4164,-95,0.461335255,0.484149856,-0.022814601
Arkansas,5043 ,Drew County,4349,2426,6908,1923,0.629559931,0.35118703,0.278372901
Arkansas,5045 ,Faulkner County,34421,18347,54428,16074,0.632413464,0.337087528,0.295325935
Arkansas,5047 ,Franklin County,5677,1300,7129,4377,0.79632487,0.182353766,0.613971104
Arkansas,5049 ,Fulton County,3961,1035,5119,2926,0.773783942,0.202187927,0.571596015
Arkansas,5051 ,Garland County,29069,14045,44199,15024,0.657684563,0.31776737,0.339917193
Arkansas,5053 ,Grant County,6794,1268,8200,5526,0.828536585,0.154634146,0.673902439
Arkansas,5055 ,Greene County,12670,3058,16100,9612,0.786956522,0.189937888,0.597018634
Arkansas,5057 ,Hempstead County,4470,2138,6848,2332,0.652745327,0.312207944,0.340537383
Arkansas,5059 ,Hot Spring County,9202,3082,12557,6120,0.732818348,0.24544079,0.487377558
Arkansas,5061 ,Howard County,3367,1340,4834,2027,0.696524617,0.277203144,0.419321473
Arkansas,5063 ,Independence County,11250,2806,14512,8444,0.775220507,0.193357222,0.581863286
Arkansas,5065 ,Izard County,4631,1021,5810,3610,0.79707401,0.175731497,0.621342513
Arkansas,5067 ,Jackson County,3593,1365,5091,2228,0.705755254,0.268120212,0.437635042
Arkansas,5069 ,Jefferson County,9521,14981,25158,-5460,0.378448207,0.595476588,-0.217028381
Arkansas,5071 ,Johnson County,6938,2283,9498,4655,0.730469573,0.240366393,0.49010318
Arkansas,5073 ,Lafayette County,1757,839,2679,918,0.655841732,0.313176558,0.342665174
Arkansas,5075 ,Lawrence County,4569,1080,5857,3489,0.780092197,0.184394741,0.595697456
Arkansas,5077 ,Lee County,1286,1423,2848,-137,0.451544944,0.499648876,-0.048103933
Arkansas,5079 ,Lincoln County,2729,1032,3875,1697,0.704258065,0.266322581,0.437935484
Arkansas,5081 ,Little River County,3715,1226,5177,2489,0.717597064,0.236816689,0.480780375
Arkansas,5083 ,Logan County,6441,1544,8225,4897,0.783100304,0.187720365,0.595379939
Arkansas,5085 ,Lonoke County,22884,6686,30662,16198,0.746330963,0.218054921,0.528276042
Arkansas,5087 ,Madison County,5658,1563,7351,4095,0.769691198,0.212624133,0.557067066
Arkansas,5089 ,Marion County,5783,1531,7503,4252,0.770758363,0.204051713,0.566706651
Arkansas,5091 ,Miller County,11920,4245,16529,7675,0.721156755,0.256821344,0.46433541
Arkansas,5093 ,Mississippi County,7262,4542,12287,2720,0.591031171,0.369658989,0.221372182
Arkansas,5095 ,Monroe County,1545,1147,2816,398,0.548650568,0.407315341,0.141335227
Arkansas,5097 ,Montgomery County,3046,731,3873,2315,0.786470436,0.188742577,0.59772786
Arkansas,5099 ,Nevada County,2133,1076,3358,1057,0.635199524,0.320428827,0.314770697
Arkansas,5101 ,Newton County,3192,709,3998,2483,0.7983992,0.177338669,0.62106053
Arkansas,5103 ,Ouachita County,5294,3995,9629,1299,0.549797487,0.414892512,0.134904975
Arkansas,5105 ,Perry County,3479,1012,4627,2467,0.751891074,0.218716231,0.533174843
Arkansas,5107 ,Phillips County,2417,3623,6242,-1206,0.387215636,0.580422941,-0.193207305
Arkansas,5109 ,Pike County,3519,644,4246,2875,0.828780028,0.151672162,0.677107866
Arkansas,5111 ,Poinsett County,5918,1424,7521,4494,0.786863449,0.189336524,0.597526925
Arkansas,5113 ,Polk County,7035,1246,8490,5789,0.828621908,0.146760895,0.681861013
Arkansas,5115 ,Pope County,18081,5772,24432,12309,0.740054028,0.236247544,0.503806483
Arkansas,5117 ,Prairie County,2786,654,3495,2132,0.79713877,0.187124464,0.610014306
Arkansas,5119 ,Pulaski County,63687,101947,169956,-38260,0.3747264,0.599843489,-0.225117089
Arkansas,5121 ,Randolph County,5355,1215,6812,4140,0.786112742,0.178361715,0.607751028
Arkansas,5123 ,St. Francis County,3242,3604,7108,-362,0.456105796,0.507034328,-0.050928531
Arkansas,5125 ,Saline County,39556,16060,56959,23496,0.694464439,0.281957197,0.412507242
Arkansas,5127 ,Scott County,2962,483,3551,2479,0.834131231,0.136018023,0.698113208
Arkansas,5129 ,Searcy County,3365,588,4019,2777,0.837272953,0.146305051,0.690967902
Arkansas,5131 ,Sebastian County,31198,14487,47140,16711,0.661815868,0.307318625,0.354497242
Arkansas,5133 ,Sevier County,3884,1116,5202,2768,0.746635909,0.214532872,0.532103037
Arkansas,5135 ,Sharp County,5938,1398,7566,4540,0.784826857,0.184773989,0.600052868
Arkansas,5137 ,Stone County,4616,1180,5938,3436,0.777366117,0.198720108,0.578646009
Arkansas,5139 ,Union County,10478,5584,16607,4894,0.630938761,0.336243753,0.294695008
Arkansas,5141 ,Van Buren County,6034,1593,7807,4441,0.772896119,0.20404765,0.568848469
Arkansas,5143 ,Washington County,47504,43824,94266,3680,0.503935671,0.464897206,0.039038466
Arkansas,5145 ,White County,24182,5978,30885,18204,0.782969079,0.193556743,0.589412336
Arkansas,5147 ,Woodruff County,1543,856,2476,687,0.623182553,0.345718901,0.277463651
Arkansas,5149 ,Yell County,5226,1284,6741,3942,0.775255897,0.19047619,0.584779706
California,6001 ,Alameda County,136238,617486,769617,-481248,0.177020518,0.802328951,-0.625308433
California,6003 ,Alpine County,238,473,736,-235,0.323369565,0.642663043,-0.319293478
California,6005 ,Amador County,13585,8153,22302,5432,0.609138194,0.365572594,0.243565599
California,6007 ,Butte County,48723,50416,102024,-1693,0.477564103,0.494158237,-0.016594135
California,6009 ,Calaveras County,16287,9845,26717,6442,0.609611858,0.368491971,0.241119886
California,6011 ,Colusa County,4539,3218,7919,1321,0.573178432,0.40636444,0.166813992
California,6013 ,Contra Costa County,152497,415573,579996,-263076,0.262927675,0.716510114,-0.453582438
California,6015 ,Del Norte County,6444,4659,11416,1785,0.564470918,0.408111423,0.156359495
California,6017 ,El Dorado County,61820,51606,116101,10214,0.532467421,0.444492296,0.087975125
California,6019 ,Fresno County,163880,192118,363271,-28238,0.451123266,0.528855868,-0.077732602
California,6021 ,Glenn County,7000,3939,11170,3061,0.626678603,0.352641003,0.274037601
California,6023 ,Humboldt County,21069,43633,66914,-22564,0.314866844,0.652075799,-0.337208955
California,6025 ,Imperial County,20040,33636,54819,-13596,0.365566683,0.613582882,-0.248016199
California,6027 ,Inyo County,4611,4623,9460,-12,0.487420719,0.488689218,-0.001268499
California,6029 ,Kern County,159980,129074,296176,30906,0.540151802,0.435801685,0.104350116
California,6031 ,Kings County,23792,18409,43273,5383,0.549811661,0.425415386,0.124396275
California,6033 ,Lake County,3955,6874,11038,-2919,0.358307664,0.622757746,-0.264450082
California,6035 ,Lassen County,8814,2775,11800,6039,0.746949153,0.235169492,0.511779661
California,6037 ,Los Angeles County,1143687,3024321,4256867,-1880634,0.268668718,0.71045701,-0.441788292
California,6039 ,Madera County,29361,23154,53690,6207,0.546861613,0.431253492,0.115608121
California,6041 ,Marin County,24610,128262,155771,-103652,0.157988329,0.823401018,-0.665412689
California,6043 ,Mariposa County,5950,4088,10280,1862,0.578793774,0.39766537,0.181128405
California,6045 ,Mendocino County,13267,28781,43335,-15514,0.306149763,0.664151379,-0.358001615
California,6047 ,Merced County,39397,48991,90541,-9594,0.435128837,0.541091881,-0.105963044
California,6049 ,Modoc County,3109,1150,4338,1959,0.716689719,0.265099124,0.451590595
California,6051 ,Mono County,2513,4013,6737,-1500,0.373014695,0.595665727,-0.222651032
California,6053 ,Monterey County,46299,113953,163883,-67654,0.282512524,0.695331425,-0.412818901
California,6055 ,Napa County,19388,46962,67847,-27574,0.285760608,0.692175041,-0.406414432
California,6057 ,Nevada County,26779,36359,64738,-9580,0.413651951,0.561633044,-0.147981093
California,6059 ,Orange County,676496,814005,1521719,-137509,0.444560395,0.534924648,-0.090364253
California,6061 ,Placer County,119013,104134,228616,14879,0.520580362,0.455497428,0.065082934
California,6063 ,Plumas County,6445,4561,11256,1884,0.572583511,0.405206112,0.167377399
California,6065 ,Riverside County,448281,527475,995249,-79194,0.45042095,0.529992997,-0.079572047
California,6067 ,Sacramento County,259394,440790,718260,-181396,0.361142205,0.613691421,-0.252549216
California,6069 ,San Benito County,10412,17315,28317,-6903,0.367694318,0.611470142,-0.243775824
California,6071 ,San Bernardino County,364325,453380,836393,-89055,0.435590685,0.542065751,-0.106475066
California,6073 ,San Diego County,599539,963797,1600272,-364258,0.374648185,0.602270739,-0.227622554
California,6075 ,San Francisco County,56329,377772,442969,-321443,0.127162397,0.852818143,-0.725655746
California,6077 ,San Joaquin County,115378,154460,275706,-39082,0.418482006,0.560234453,-0.141752446
California,6079 ,San Luis Obispo County,66661,87491,158035,-20830,0.421811624,0.553617869,-0.131806245
California,6081 ,San Mateo County,75505,291215,373800,-215710,0.201993044,0.779066346,-0.577073301
California,6083 ,Santa Barbara County,63583,126419,194378,-62836,0.327110064,0.6503771,-0.323267036
California,6085 ,Santa Clara County,214538,617824,850297,-403286,0.252309487,0.726597883,-0.474288396
California,6087 ,Santa Cruz County,26821,113874,144295,-87053,0.185876156,0.789174954,-0.603298798
California,6089 ,Shasta County,60372,29874,92326,30498,0.65390031,0.323570825,0.330329485
California,6091 ,Sierra County,1142,730,1930,412,0.591709845,0.378238342,0.213471503
California,6093 ,Siskiyou County,13288,9591,23446,3697,0.566749126,0.409067645,0.157681481
California,6095 ,Solano County,69306,131639,205831,-62333,0.336713129,0.63954895,-0.302835822
California,6097 ,Sonoma County,61825,199938,268252,-138113,0.230473585,0.745336475,-0.51486289
California,6099 ,Stanislaus County,104145,105841,214876,-1696,0.484674882,0.492567807,-0.007892924
California,6101 ,Sutter County,24372,17364,42634,7008,0.571656424,0.407280574,0.16437585
California,6103 ,Tehama County,18865,8802,28319,10063,0.666160528,0.31081606,0.355344468
California,6105 ,Trinity County,3188,2851,6258,337,0.509427932,0.455576862,0.053851071
California,6107 ,Tulare County,77413,65944,146487,11469,0.528463277,0.45016964,0.078293637
California,6109 ,Tuolumne County,17689,11978,30401,5711,0.58185586,0.394000197,0.187855663
California,6111 ,Ventura County,162146,251298,422539,-89152,0.383742092,0.594733267,-0.210991175
California,6113 ,Yolo County,22422,58328,82624,-35906,0.271373935,0.705945004,-0.434571069
California,6115 ,Yuba County,16210,10343,27329,5867,0.593142815,0.378462439,0.214680376
Colorado,8001 ,Adams County,95657,134202,236735,-38545,0.40406784,0.566887026,-0.162819186
Colorado,8003 ,Alamosa County,3813,3759,7808,54,0.488345287,0.481429303,0.006915984
Colorado,8005 ,Arapahoe County,127323,213607,350183,-86284,0.363589894,0.609986778,-0.246396884
Colorado,8007 ,Archuleta County,5189,3738,9144,1451,0.567475941,0.408792651,0.15868329
Colorado,8009 ,Baca County,1867,317,2225,1550,0.839101124,0.14247191,0.696629213
Colorado,8011 ,Bent County,1503,732,2274,771,0.660949868,0.321899736,0.339050132
Colorado,8013 ,Boulder County,42501,159089,206111,-116588,0.206204424,0.771860793,-0.56565637
Colorado,8014 ,Broomfield County,16295,29077,46632,-12782,0.349438154,0.623541774,-0.27410362
Colorado,8015 ,Chaffee County,6222,7160,13717,-938,0.453597725,0.521980025,-0.068382299
Colorado,8017 ,Cheyenne County,993,131,1136,862,0.874119718,0.115316901,0.758802817
Colorado,8019 ,Clear Creek County,2754,3604,6548,-850,0.420586439,0.550397068,-0.129810629
Colorado,8021 ,Conejos County,2286,1959,4333,327,0.527579045,0.452111701,0.075467344
Colorado,8023 ,Costilla County,741,1311,2094,-570,0.353868195,0.626074499,-0.272206304
Colorado,8025 ,Crowley County,1271,437,1750,834,0.726285714,0.249714286,0.476571429
Colorado,8027 ,Custer County,2474,1112,3634,1362,0.680792515,0.305998899,0.374793616
Colorado,8029 ,Delta County,13081,5887,19370,7194,0.675322664,0.303923593,0.371399071
Colorado,8031 ,Denver County,71617,313292,393824,-241675,0.181850268,0.795512716,-0.613662448
Colorado,8033 ,Dolores County,1089,341,1449,748,0.751552795,0.235334714,0.516218081
Colorado,8035 ,Douglas County,121270,104653,231599,16617,0.523620568,0.451871554,0.071749014
Colorado,8037 ,Eagle County,9892,18588,29140,-8696,0.339464653,0.637886067,-0.298421414
Colorado,8039 ,Elbert County,14027,4490,18983,9537,0.738924301,0.236527419,0.502396881
Colorado,8041 ,El Paso County,202828,161941,378849,40887,0.535379531,0.427455266,0.107924265
Colorado,8043 ,Fremont County,17517,7369,25557,10148,0.685409086,0.288335877,0.397073209
Colorado,8045 ,Garfield County,14717,15427,30904,-710,0.476216671,0.499191043,-0.022974372
Colorado,8047 ,Gilpin County,1833,2223,4186,-390,0.437888199,0.531055901,-0.093167702
Colorado,8049 ,Grand County,4883,4710,9870,173,0.49473151,0.477203647,0.017527862
Colorado,8051 ,Gunnison County,3599,6976,10887,-3377,0.330577753,0.640764214,-0.310186461
Colorado,8053 ,Hinsdale County,353,255,632,98,0.558544304,0.403481013,0.155063291
Colorado,8055 ,Huerfano County,2203,2076,4406,127,0.5,0.47117567,0.02882433
Colorado,8057 ,Jackson County,681,175,876,506,0.77739726,0.199771689,0.577625571
Colorado,8059 ,Jefferson County,148417,218396,377357,-69979,0.393306604,0.578751686,-0.185445083
Colorado,8061 ,Kiowa County,795,98,903,697,0.880398671,0.108527132,0.771871539
Colorado,8063 ,Kit Carson County,3144,662,3871,2482,0.812193232,0.171015242,0.64117799
Colorado,8065 ,Lake County,1497,2303,3961,-806,0.377934865,0.581418834,-0.203483969
Colorado,8067 ,La Plata County,14233,20548,35667,-6315,0.399052345,0.576106765,-0.17705442
Colorado,8069 ,Larimer County,91489,126120,224338,-34631,0.407817668,0.562187414,-0.154369746
Colorado,8071 ,Las Animas County,4284,3497,7961,787,0.538123351,0.439266424,0.098856928
Colorado,8073 ,Lincoln County,2135,470,2651,1665,0.805356469,0.177291588,0.628064881
Colorado,8075 ,Logan County,8087,2218,10532,5869,0.767850361,0.210596278,0.557254083
Colorado,8077 ,Mesa County,56894,31536,90622,25358,0.627816645,0.347994968,0.279821677
Colorado,8079 ,Mineral County,427,317,756,110,0.564814815,0.419312169,0.145502646
Colorado,8081 ,Moffat County,5670,1203,7026,4467,0.807002562,0.171221178,0.635781383
Colorado,8083 ,Montezuma County,9306,5836,15500,3470,0.600387097,0.376516129,0.223870968
Colorado,8085 ,Montrose County,16770,7687,24922,9083,0.672899446,0.30844234,0.364457106
Colorado,8087 ,Morgan County,9593,3876,13744,5717,0.697977299,0.28201397,0.415963329
Colorado,8089 ,Otero County,5756,3605,9576,2151,0.601086048,0.376461988,0.22462406
Colorado,8091 ,Ouray County,1577,2365,4020,-788,0.392288557,0.588308458,-0.1960199
Colorado,8093 ,Park County,6991,4903,12290,2088,0.568836452,0.398942229,0.169894223
Colorado,8095 ,Phillips County,1958,486,2485,1472,0.787927565,0.195573441,0.592354125
Colorado,8097 ,Pitkin County,2780,8989,11957,-6209,0.232499791,0.751777202,-0.519277411
Colorado,8099 ,Prowers County,4008,1458,5561,2550,0.720733681,0.262183061,0.45855062
Colorado,8101 ,Pueblo County,42252,43772,88299,-1520,0.478510515,0.495724753,-0.017214238
Colorado,8103 ,Rio Blanco County,3061,561,3691,2500,0.829314549,0.15199133,0.677323219
Colorado,8105 ,Rio Grande County,3660,2495,6305,1165,0.580491673,0.395717684,0.184773989
Colorado,8107 ,Routt County,5925,10582,16876,-4657,0.351090306,0.627044323,-0.275954018
Colorado,8109 ,Saguache County,1413,1884,3389,-471,0.41693715,0.555916199,-0.13897905
Colorado,8111 ,San Juan County,202,342,563,-140,0.358792185,0.607460036,-0.248667851
Colorado,8113 ,San Miguel County,1136,3924,5147,-2788,0.220711094,0.762385856,-0.541674762
Colorado,8115 ,Sedgwick County,1121,301,1446,820,0.775242047,0.208160443,0.567081604
Colorado,8117 ,Summit County,5319,12620,18465,-7301,0.288058489,0.683455185,-0.395396696
Colorado,8119 ,Teller County,11241,5278,16939,5963,0.663616506,0.311588642,0.352027865
Colorado,8121 ,Washington County,2595,369,3008,2226,0.862699468,0.122672872,0.740026596
Colorado,8123 ,Weld County,96145,66060,166968,30085,0.575828901,0.395644674,0.180184227
Colorado,8125 ,Yuma County,4107,785,4981,3322,0.824533226,0.157598876,0.666934351
Connecticut,9001 ,Fairfield County,169039,297505,473005,-128466,0.357372544,0.628967981,-0.271595438
Connecticut,9003 ,Hartford County,159024,283368,449335,-124344,0.353909667,0.63063861,-0.276728944
Connecticut,9005 ,Litchfield County,55601,50164,107549,5437,0.516982957,0.466429256,0.050553701
Connecticut,9007 ,Middlesex County,40665,56848,99198,-16183,0.4099377,0.57307607,-0.16313837
Connecticut,9009 ,New Haven County,169892,242629,418003,-72737,0.406437274,0.580447987,-0.174010713
Connecticut,9011 ,New London County,57110,79459,139604,-22349,0.4090857,0.569174236,-0.160088536
Connecticut,9013 ,Tolland County,34819,44006,80546,-9187,0.43228714,0.546346187,-0.114059047
Connecticut,9015 ,Windham County,29141,26701,57077,2440,0.510555916,0.467806647,0.042749269
Delaware,10001 ,Kent County,41009,44552,87025,-3543,0.471232404,0.511944843,-0.040712439
Delaware,10003 ,New Castle County,88364,195034,287633,-106670,0.307210925,0.678065451,-0.370854526
Delaware,10005 ,Sussex County,71230,56682,129352,14548,0.550667945,0.438199641,0.112468304
District of Columbia,11001 ,District of Columbia,18586,317323,344356,-298737,0.053973214,0.921496939,-0.867523725
Florida,12001 ,Alachua County,50972,89704,142604,-38732,0.357437379,0.629042664,-0.271605285
Florida,12003 ,Baker County,11911,2037,14059,9874,0.847215307,0.144889395,0.702325912
Florida,12005 ,Bay County,66097,25614,93024,40483,0.710537066,0.275348297,0.435188768
Florida,12007 ,Bradford County,10334,3160,13632,7174,0.758069249,0.231807512,0.526261737
Florida,12009 ,Brevard County,207883,148549,360764,59334,0.57622989,0.41176226,0.16446763
Florida,12011 ,Broward County,333409,618752,957672,-285343,0.348145294,0.646100126,-0.297954832
Florida,12013 ,Calhoun County,5274,1209,6526,4065,0.808152007,0.185258964,0.622893043
Florida,12015 ,Charlotte County,73243,42273,116340,30970,0.629559911,0.363357401,0.26620251
Florida,12017 ,Citrus County,65352,27092,93208,38260,0.701141533,0.290661746,0.410479787
Florida,12019 ,Clay County,84480,38317,124405,46163,0.679072385,0.30800209,0.371070295
Florida,12021 ,Collier County,128950,77621,207818,51329,0.620494856,0.373504701,0.246990155
Florida,12023 ,Columbia County,23836,8914,33042,14922,0.721384904,0.269777858,0.451607046
Florida,12027 ,DeSoto County,8313,4259,12659,4054,0.656686942,0.336440477,0.320246465
Florida,12029 ,Dixie County,6759,1365,8167,5394,0.827598874,0.167136035,0.660462838
Florida,12031 ,Duval County,233762,252556,492820,-18794,0.474335457,0.512471085,-0.038135628
Florida,12033 ,Escambia County,96674,70929,170372,25745,0.56742892,0.416318409,0.151110511
Florida,12035 ,Flagler County,43043,28161,71716,14882,0.600186848,0.39267388,0.207512968
Florida,12037 ,Franklin County,4675,2120,6849,2555,0.682581399,0.309534239,0.37304716
Florida,12039 ,Gadsden County,7465,16153,23762,-8688,0.314157057,0.679782847,-0.365625789
Florida,12041 ,Gilchrist County,7895,1700,9685,6195,0.81517811,0.175529169,0.639648942
Florida,12043 ,Glades County,3782,1385,5193,2397,0.72828808,0.26670518,0.4615829
Florida,12045 ,Gulf County,6113,1985,8163,4128,0.748866838,0.243170403,0.505696435
Florida,12047 ,Hamilton County,3815,1963,5830,1852,0.654373928,0.33670669,0.317667238
Florida,12049 ,Hardee County,6122,2298,8485,3824,0.721508544,0.270830878,0.450677666
Florida,12051 ,Hendry County,7906,4929,12940,2977,0.610973725,0.380911901,0.230061824
Florida,12053 ,Hernando County,70412,37519,108922,32893,0.646444245,0.344457502,0.301986743
Florida,12055 ,Highlands County,34873,16938,52170,17935,0.6684493,0.32466935,0.34377995
Florida,12057 ,Hillsborough County,327398,376367,712063,-48969,0.459787968,0.528558569,-0.0687706
Florida,12059 ,Holmes County,8080,924,9068,7156,0.891045434,0.10189678,0.789148655
Florida,12061 ,Indian River County,58872,37844,97484,21028,0.603914489,0.388207296,0.215707193
Florida,12063 ,Jackson County,15488,6766,22419,8722,0.690842589,0.301797582,0.389045006
Florida,12065 ,Jefferson County,4479,3897,8451,582,0.52999645,0.46112886,0.06886759
Florida,12067 ,Lafayette County,3128,510,3658,2618,0.855112083,0.139420448,0.715691635
Florida,12069 ,Lake County,125859,83505,211314,42354,0.595601806,0.395170221,0.200431585
Florida,12071 ,Lee County,233247,157695,393899,75552,0.592149257,0.400343743,0.191805514
Florida,12073 ,Leon County,57453,103517,162929,-46064,0.35262599,0.635350367,-0.282724377
Florida,12075 ,Levy County,16749,6205,23145,10544,0.723655217,0.268092461,0.455562757
Florida,12077 ,Liberty County,2846,694,3561,2152,0.799213704,0.194889076,0.604324628
Florida,12079 ,Madison County,5576,3747,9380,1829,0.59445629,0.399466951,0.194989339
Florida,12081 ,Manatee County,124987,90166,216958,34821,0.57608846,0.415591958,0.160496502
Florida,12083 ,Marion County,127826,74858,204376,52968,0.625445258,0.366275884,0.259169374
Florida,12085 ,Martin County,61168,36893,98726,24275,0.619573365,0.373690821,0.245882544
Florida,12086 ,Miami-Dade County,532833,617864,1156816,-85031,0.460603069,0.534107412,-0.073504343
Florida,12087 ,Monroe County,25693,21881,48029,3812,0.534947636,0.455578921,0.079368715
Florida,12089 ,Nassau County,42566,15564,58811,27002,0.723776164,0.264644369,0.459131795
Florida,12091 ,Okaloosa County,79798,34248,116373,45550,0.685708884,0.294295068,0.391413816
Florida,12093 ,Okeechobee County,11470,4390,15954,7080,0.718941958,0.275166103,0.443775856
Florida,12095 ,Orange County,245398,395014,647403,-149616,0.379049834,0.610151637,-0.231101802
Florida,12097 ,Osceola County,73480,97297,172436,-23817,0.426129115,0.564249925,-0.13812081
Florida,12099 ,Palm Beach County,334711,433572,773158,-98861,0.4329141,0.560780591,-0.12786649
Florida,12101 ,Pasco County,179621,119073,301970,60548,0.594830612,0.394320628,0.200509984
Florida,12103 ,Pinellas County,276209,277450,559715,-1241,0.493481504,0.495698704,-0.0022172
Florida,12105 ,Polk County,194586,145049,343256,49537,0.566883026,0.422567996,0.14431503
Florida,12107 ,Putnam County,25514,10527,36373,14987,0.701454375,0.289417975,0.412036401
Florida,12109 ,St. Johns County,110946,63850,176622,47096,0.628155043,0.361506494,0.266648549
Florida,12111 ,St. Lucie County,86831,84137,172169,2694,0.504335856,0.48868844,0.015647416
Florida,12113 ,Santa Rosa County,77385,27612,106928,49773,0.723711282,0.258229837,0.465481445
Florida,12115 ,Sarasota County,148370,120110,270575,28260,0.548350735,0.443906495,0.104444239
Florida,12117 ,Seminole County,125241,132528,260815,-7287,0.48019094,0.508130284,-0.027939344
Florida,12119 ,Sumter County,62761,29341,92485,33420,0.678607342,0.317251446,0.361355896
Florida,12121 ,Suwannee County,16410,4485,21057,11925,0.779313292,0.212993304,0.566319989
Florida,12123 ,Taylor County,7751,2299,10127,5452,0.765379678,0.227016886,0.538362793
Florida,12125 ,Union County,5133,1053,6245,4080,0.82193755,0.168614892,0.653322658
Florida,12127 ,Volusia County,173821,130575,307439,43246,0.565383702,0.424718399,0.140665303
Florida,12129 ,Wakulla County,12874,5351,18404,7523,0.699521843,0.29075201,0.408769833
Florida,12131 ,Walton County,32947,10338,43711,22609,0.753746197,0.236507973,0.517238224
Florida,12133 ,Washington County,9876,2347,12327,7529,0.801168167,0.190395068,0.6107731
Georgia,13001 ,Appling County,6526,1779,8341,4747,0.782400192,0.213283779,0.569116413
Georgia,13003 ,Atkinson County,2300,825,3155,1475,0.729001585,0.261489699,0.467511886
Georgia,13005 ,Bacon County,4018,625,4668,3393,0.86075407,0.133890317,0.726863753
Georgia,13007 ,Baker County,897,652,1555,245,0.576848875,0.419292605,0.15755627
Georgia,13009 ,Baldwin County,8903,9140,18251,-237,0.487808887,0.500794477,-0.01298559
Georgia,13011 ,Banks County,7795,932,8801,6863,0.885694807,0.105897057,0.77979775
Georgia,13013 ,Barrow County,26804,10453,37921,16351,0.7068379,0.275652013,0.431185886
Georgia,13015 ,Bartow County,37674,12092,50467,25582,0.746507619,0.239602116,0.506905503
Georgia,13017 ,Ben Hill County,4110,2392,6560,1718,0.62652439,0.364634146,0.261890244
Georgia,13019 ,Berrien County,6419,1269,7743,5150,0.829006845,0.163889965,0.66511688
Georgia,13021 ,Bibb County,26585,43468,70802,-16883,0.375483743,0.613937459,-0.238453716
Georgia,13023 ,Bleckley County,4328,1311,5706,3017,0.758499825,0.229758149,0.528741675
Georgia,13025 ,Brantley County,6991,699,7746,6292,0.902530338,0.090240124,0.812290214
Georgia,13027 ,Brooks County,4260,2790,7100,1470,0.6,0.392957746,0.207042254
Georgia,13029 ,Bryan County,14244,6739,21340,7505,0.667478913,0.31579194,0.351686973
Georgia,13031 ,Bulloch County,18386,11243,30084,7143,0.611155431,0.37372025,0.237435181
Georgia,13033 ,Burke County,5400,5209,10684,191,0.505428678,0.487551479,0.0178772
Georgia,13035 ,Butts County,8406,3274,11786,5132,0.713219073,0.277787205,0.435431868
Georgia,13037 ,Calhoun County,923,1260,2194,-337,0.420692799,0.574293528,-0.153600729
Georgia,13039 ,Camden County,15251,7967,23688,7284,0.643828099,0.336330632,0.307497467
Georgia,13043 ,Candler County,3133,1269,4431,1864,0.707063868,0.286391334,0.420672534
Georgia,13045 ,Carroll County,37476,16238,54474,21238,0.687961229,0.298087161,0.389874068
Georgia,13047 ,Catoosa County,25167,6932,32651,18235,0.770788031,0.212305902,0.558482129
Georgia,13049 ,Charlton County,3419,1103,4566,2316,0.748795445,0.241568112,0.507227332
Georgia,13051 ,Chatham County,53237,78254,133420,-25017,0.399018138,0.58652376,-0.187505621
Georgia,13053 ,Chattahoochee County,880,667,1582,213,0.556257901,0.421618205,0.134639697
Georgia,13055 ,Chattooga County,8064,1854,10050,6210,0.80238806,0.184477612,0.617910448
Georgia,13057 ,Cherokee County,99587,42794,144830,56793,0.687613064,0.295477456,0.392135607
Georgia,13059 ,Clarke County,14446,36048,51333,-21602,0.281417412,0.702238326,-0.420820914
Georgia,13061 ,Clay County,637,790,1434,-153,0.444211994,0.550906555,-0.106694561
Georgia,13063 ,Clayton County,15813,95476,112344,-79663,0.140755181,0.84985402,-0.709098839
Georgia,13065 ,Clinch County,2105,747,2864,1358,0.734986034,0.260824022,0.474162011
Georgia,13067 ,Cobb County,165459,221846,393746,-56387,0.420217602,0.563424136,-0.143206534
Georgia,13069 ,Coffee County,10578,4511,15214,6067,0.695280663,0.296503221,0.398777442
Georgia,13071 ,Colquitt County,11777,4187,16083,7590,0.732263881,0.260337002,0.471926879
Georgia,13073 ,Columbia County,50013,29236,80579,20777,0.620670398,0.362824061,0.257846337
Georgia,13075 ,Cook County,4900,2059,7035,2841,0.696517413,0.29267946,0.403837953
Georgia,13077 ,Coweta County,51501,24210,76799,27291,0.670594669,0.31523848,0.35535619
Georgia,13079 ,Crawford County,4428,1615,6102,2813,0.725663717,0.264667322,0.460996395
Georgia,13081 ,Crisp County,4987,2986,8050,2001,0.619503106,0.370931677,0.248571429
Georgia,13083 ,Dade County,6066,1261,7434,4805,0.81598063,0.169626043,0.646354587
Georgia,13085 ,Dawson County,13398,2486,16081,10912,0.833157142,0.154592376,0.678564766
Georgia,13087 ,Decatur County,6758,4780,11627,1978,0.581233336,0.411112067,0.170121269
Georgia,13089 ,DeKalb County,58373,308227,370804,-249854,0.157422789,0.831239685,-0.673816895
Georgia,13091 ,Dodge County,5843,2171,8070,3672,0.724039653,0.269021066,0.455018587
Georgia,13093 ,Dooly County,2159,1911,4105,248,0.525943971,0.465529842,0.060414129
Georgia,13095 ,Dougherty County,10454,24577,35311,-14123,0.296055054,0.696015406,-0.399960352
Georgia,13097 ,Douglas County,25451,42809,69097,-17358,0.368337265,0.619549329,-0.251212064
Georgia,13099 ,Early County,2722,2437,5187,285,0.524773472,0.469828417,0.054945055
Georgia,13101 ,Echols County,1256,167,1441,1089,0.871616933,0.115891742,0.755725191
Georgia,13103 ,Effingham County,23358,7720,31570,15638,0.739879633,0.244535952,0.495343681
Georgia,13105 ,Elbert County,6226,2879,9171,3347,0.678879075,0.313924327,0.364954749
Georgia,13107 ,Emanuel County,6551,2884,9501,3667,0.689506368,0.303546995,0.385959373
Georgia,13109 ,Evans County,2888,1324,4247,1564,0.680009418,0.31174947,0.368259948
Georgia,13111 ,Fannin County,12169,2571,14850,9598,0.819461279,0.173131313,0.646329966
Georgia,13113 ,Fayette County,37952,33065,71993,4887,0.527162363,0.459280763,0.0678816
Georgia,13115 ,Floyd County,29123,12008,41648,17115,0.699265271,0.288321168,0.410944103
Georgia,13117 ,Forsyth County,85122,42203,129305,42919,0.65830401,0.326383357,0.331920653
Georgia,13119 ,Franklin County,9069,1593,10765,7476,0.842452392,0.147979563,0.694472829
Georgia,13121 ,Fulton County,137240,381144,524659,-243904,0.261579426,0.726460425,-0.464880999
Georgia,13123 ,Gilmer County,13429,2932,16525,10497,0.812647504,0.177428139,0.635219365
Georgia,13125 ,Glascock County,1403,155,1566,1248,0.895913155,0.098978289,0.796934866
Georgia,13127 ,Glynn County,25616,15879,41984,9737,0.610137195,0.378215511,0.231921684
Georgia,13129 ,Gordon County,19405,4384,24033,15021,0.807431448,0.182415845,0.625015604
Georgia,13131 ,Grady County,7034,3619,10707,3415,0.656953395,0.338003175,0.318950219
Georgia,13133 ,Greene County,7068,4088,11247,2980,0.628434249,0.363474704,0.264959545
Georgia,13135 ,Gwinnett County,166413,241827,413865,-75414,0.402094886,0.584313725,-0.182218839
Georgia,13137 ,Habersham County,16637,3563,20432,13074,0.814261942,0.17438332,0.639878622
Georgia,13139 ,Hall County,64170,25031,90523,39139,0.708880616,0.276515361,0.432365255
Georgia,13141 ,Hancock County,1159,2985,4165,-1826,0.278271309,0.716686675,-0.438415366
Georgia,13143 ,Haralson County,12331,1792,14248,10539,0.865454801,0.125772038,0.739682762
Georgia,13145 ,Harris County,14319,5457,19991,8862,0.716272323,0.272972838,0.443299485
Georgia,13147 ,Hart County,9464,3157,12727,6307,0.743615935,0.248055315,0.495560619
Georgia,13149 ,Heard County,4516,824,5391,3692,0.83769245,0.152847338,0.684845112
Georgia,13151 ,Henry County,48187,73276,122742,-25089,0.392587704,0.596992065,-0.20440436
Georgia,13153 ,Houston County,41534,32232,74823,9302,0.555096695,0.430776633,0.124320062
Georgia,13155 ,Irwin County,3134,1008,4168,2126,0.751919386,0.24184261,0.510076775
Georgia,13157 ,Jackson County,29497,7642,37670,21855,0.783036899,0.202867003,0.580169896
Georgia,13159 ,Jasper County,5822,1761,7644,4061,0.761643119,0.230376766,0.531266353
Georgia,13161 ,Jeff Davis County,4695,1028,5771,3667,0.813550511,0.17813204,0.635418472
Georgia,13163 ,Jefferson County,3537,4061,7642,-524,0.462836954,0.531405391,-0.068568438
Georgia,13165 ,Jenkins County,2161,1266,3455,895,0.625470333,0.36642547,0.259044863
Georgia,13167 ,Johnson County,2850,1222,4100,1628,0.695121951,0.29804878,0.397073171
Georgia,13169 ,Jones County,9965,4888,14966,5077,0.665842577,0.326606976,0.339235601
Georgia,13171 ,Lamar County,6330,2615,9039,3715,0.700298706,0.289301914,0.410996792
Georgia,13173 ,Lanier County,2509,1019,3576,1490,0.701621924,0.284955257,0.416666667
Georgia,13175 ,Laurens County,14493,8073,22729,6420,0.637643539,0.355185006,0.282458533
Georgia,13177 ,Lee County,12007,4558,16714,7449,0.718379801,0.272705516,0.445674285
Georgia,13179 ,Liberty County,7959,13099,21389,-5140,0.372107158,0.612417598,-0.24031044
Georgia,13181 ,Lincoln County,3179,1435,4650,1744,0.683655914,0.308602151,0.375053763
Georgia,13183 ,Long County,3528,2033,5656,1495,0.623762376,0.359441301,0.264321075
Georgia,13185 ,Lowndes County,25691,20117,46355,5574,0.554222845,0.433976917,0.120245928
Georgia,13187 ,Lumpkin County,12163,3126,15531,9037,0.783143391,0.20127487,0.581868521
Georgia,13189 ,McDuffie County,6169,4168,10455,2001,0.590052606,0.398660928,0.191391679
Georgia,13191 ,McIntosh County,4016,2612,6696,1404,0.599761051,0.390083632,0.209677419
Georgia,13193 ,Macon County,1783,2857,4662,-1074,0.382453882,0.612827113,-0.23037323
Georgia,13195 ,Madison County,11326,3411,14937,7915,0.758251322,0.228359108,0.529892214
Georgia,13197 ,Marion County,2275,1311,3624,964,0.627759382,0.361754967,0.266004415
Georgia,13199 ,Meriwether County,6524,4287,10877,2237,0.599797738,0.394134412,0.205663326
Georgia,13201 ,Miller County,2066,749,2835,1317,0.728747795,0.264197531,0.464550265
Georgia,13205 ,Mitchell County,4935,3995,8963,940,0.550596898,0.445721299,0.1048756
Georgia,13207 ,Monroe County,11060,4384,15592,6676,0.709338122,0.281169831,0.428168291
Georgia,13209 ,Montgomery County,2960,979,3966,1981,0.746343923,0.24684821,0.499495714
Georgia,13211 ,Morgan County,8230,3355,11707,4875,0.702998206,0.286580678,0.416417528
Georgia,13213 ,Murray County,12943,2302,15389,10641,0.841055299,0.149587368,0.691467932
Georgia,13215 ,Muscogee County,30049,49529,80543,-19480,0.373080218,0.614938604,-0.241858386
Georgia,13217 ,Newton County,23869,29794,54239,-5925,0.440070798,0.549309537,-0.10923874
Georgia,13219 ,Oconee County,16595,8162,25168,8433,0.65936904,0.324300699,0.335068341
Georgia,13221 ,Oglethorpe County,5593,2436,8131,3157,0.687861272,0.299594146,0.388267126
Georgia,13223 ,Paulding County,54525,29704,85385,24821,0.638578205,0.347883118,0.290695087
Georgia,13225 ,Peach County,6502,5920,12545,582,0.518294141,0.471901156,0.046392985
Georgia,13227 ,Pickens County,14075,2808,17116,11267,0.822329984,0.164057023,0.658272961
Georgia,13229 ,Pierce County,7899,1100,9048,6799,0.87301061,0.121573828,0.751436782
Georgia,13231 ,Pike County,9127,1505,10720,7622,0.851399254,0.140391791,0.711007463
Georgia,13233 ,Polk County,13589,3658,17399,9931,0.781021898,0.210241968,0.57077993
Georgia,13235 ,Pulaski County,2805,1217,4059,1588,0.691056911,0.299827544,0.391229367
Georgia,13237 ,Putnam County,8291,3448,11855,4843,0.699367356,0.290847744,0.408519612
Georgia,13239 ,Quitman County,604,497,1106,107,0.546112116,0.449367089,0.096745027
Georgia,13241 ,Rabun County,7474,1984,9568,5490,0.781145485,0.20735786,0.573787625
Georgia,13243 ,Randolph County,1391,1671,3074,-280,0.45250488,0.543591412,-0.091086532
Georgia,13245 ,Richmond County,26781,59124,87016,-32343,0.307770985,0.679461249,-0.371690264
Georgia,13247 ,Rockdale County,13012,31244,44686,-18232,0.291187397,0.699189903,-0.408002506
Georgia,13249 ,Schley County,1800,462,2275,1338,0.791208791,0.203076923,0.588131868
Georgia,13251 ,Screven County,3916,2661,6628,1255,0.590826795,0.401478576,0.18934822
Georgia,13253 ,Seminole County,2611,1254,3884,1357,0.672245108,0.322863028,0.34938208
Georgia,13255 ,Spalding County,18057,11784,30116,6273,0.599581618,0.391287024,0.208294594
Georgia,13257 ,Stephens County,9368,2385,11885,6983,0.788220446,0.200673117,0.587547329
Georgia,13259 ,Stewart County,801,1182,1990,-381,0.402512563,0.593969849,-0.191457286
Georgia,13261 ,Sumter County,5732,6318,12150,-586,0.471769547,0.52,-0.048230453
Georgia,13263 ,Talbot County,1392,2114,3522,-722,0.395229983,0.600227144,-0.204997161
Georgia,13265 ,Taliaferro County,360,561,928,-201,0.387931034,0.604525862,-0.216594828
Georgia,13267 ,Tattnall County,6053,2061,8183,3992,0.739704265,0.25186362,0.487840645
Georgia,13269 ,Taylor County,2418,1387,3839,1031,0.629851524,0.361292003,0.268559521
Georgia,13271 ,Telfair County,2825,1487,4333,1338,0.651973229,0.343180245,0.308792984
Georgia,13273 ,Terrell County,2004,2376,4416,-372,0.453804348,0.538043478,-0.08423913
Georgia,13275 ,Thomas County,12954,8708,21853,4246,0.592779023,0.398480758,0.194298266
Georgia,13277 ,Tift County,10784,5322,16283,5462,0.66228582,0.326843948,0.335441872
Georgia,13279 ,Toombs County,7872,2939,10914,4933,0.721275426,0.269287154,0.451988272
Georgia,13281 ,Towns County,6384,1550,7979,4834,0.800100263,0.194259932,0.605840331
Georgia,13283 ,Treutlen County,2101,952,3077,1149,0.68280793,0.309392265,0.373415665
Georgia,13285 ,Troup County,18143,11578,30049,6565,0.603780492,0.385304003,0.218476488
Georgia,13287 ,Turner County,2349,1410,3792,939,0.619462025,0.371835443,0.247626582
Georgia,13289 ,Twiggs County,2370,2044,4444,326,0.53330333,0.459945995,0.073357336
Georgia,13291 ,Union County,12651,2801,15560,9850,0.813046272,0.180012853,0.633033419
Georgia,13293 ,Upson County,8608,4201,12905,4407,0.667028284,0.325532739,0.341495544
Georgia,13295 ,Walker County,23174,5769,29354,17405,0.789466512,0.196531989,0.592934523
Georgia,13297 ,Walton County,37842,12682,51095,25160,0.740620413,0.248204325,0.492416088
Georgia,13299 ,Ware County,9865,4211,14192,5654,0.695109921,0.29671646,0.398393461
Georgia,13301 ,Warren County,1166,1469,2651,-303,0.439834025,0.554130517,-0.114296492
Georgia,13303 ,Washington County,4663,4730,9459,-67,0.492969659,0.50005286,-0.007083201
Georgia,13305 ,Wayne County,9987,2687,12778,7300,0.781577712,0.210283299,0.571294412
Georgia,13307 ,Webster County,748,639,1390,109,0.538129496,0.45971223,0.078417266
Georgia,13309 ,Wheeler County,1583,689,2285,894,0.692778993,0.301531729,0.391247265
Georgia,13311 ,White County,12222,2411,14816,9811,0.824919006,0.162729482,0.662189525
Georgia,13313 ,Whitfield County,25636,10670,36746,14966,0.697654166,0.290371741,0.407282425
Georgia,13315 ,Wilcox County,2403,862,3281,1541,0.732398659,0.262724779,0.46967388
Georgia,13317 ,Wilkes County,2823,2160,5029,663,0.561344204,0.429508849,0.131835355
Georgia,13319 ,Wilkinson County,2664,2075,4770,589,0.558490566,0.435010482,0.123480084
Georgia,13321 ,Worth County,6830,2395,9285,4435,0.735595046,0.257942919,0.477652127
Hawaii,15001 ,Hawaii County,26897,58731,87814,-31834,0.306295124,0.668811351,-0.362516227
Hawaii,15003 ,Honolulu County,136259,238869,382114,-102610,0.356592535,0.625124963,-0.268532427
Hawaii,15007 ,Kauai County,11582,21225,33497,-9643,0.345762307,0.633638833,-0.287876526
Hawaii,15009 ,Maui County,22126,47305,71044,-25179,0.311440797,0.665854963,-0.354414166
Idaho,16001 ,Ada County,130699,120539,259389,10160,0.503872562,0.464703592,0.03916897
Idaho,16003 ,Adams County,1941,591,2586,1350,0.750580046,0.228538283,0.522041763
Idaho,16005 ,Bannock County,23331,14682,39553,8649,0.589866761,0.371198139,0.218668622
Idaho,16007 ,Bear Lake County,2914,350,3315,2564,0.879034691,0.105580694,0.773453997
Idaho,16009 ,Benewah County,3878,977,4973,2901,0.779810979,0.196460889,0.58335009
Idaho,16011 ,Bingham County,15295,4124,20094,11171,0.761172489,0.205235394,0.555937096
Idaho,16013 ,Blaine County,4031,8919,13288,-4888,0.303356412,0.671207104,-0.367850692
Idaho,16015 ,Boise County,3485,1204,4820,2281,0.723029046,0.249792531,0.473236515
Idaho,16017 ,Bonner County,18369,8310,27352,10059,0.671577947,0.303816906,0.367761041
Idaho,16019 ,Bonneville County,37805,14254,53995,23551,0.700157422,0.263987406,0.436170016
Idaho,16021 ,Boundary County,4937,1220,6313,3717,0.782037066,0.19325202,0.588785047
Idaho,16023 ,Butte County,1202,188,1415,1014,0.849469965,0.132862191,0.716607774
Idaho,16025 ,Camas County,507,149,754,358,0.672413793,0.197612732,0.474801061
Idaho,16027 ,Canyon County,61759,25881,90438,35878,0.682887724,0.286173953,0.396713771
Idaho,16029 ,Caribou County,2906,431,3416,2475,0.850702576,0.12617096,0.724531616
Idaho,16031 ,Cassia County,7907,1464,9629,6443,0.82116523,0.15204071,0.66912452
Idaho,16033 ,Clark County,264,41,311,223,0.848874598,0.131832797,0.717041801
Idaho,16035 ,Clearwater County,3453,877,4419,2576,0.781398506,0.19846119,0.582937316
Idaho,16037 ,Custer County,2089,603,2739,1486,0.762687112,0.220153341,0.542533771
Idaho,16039 ,Elmore County,7246,2601,10205,4645,0.710044096,0.254875061,0.455169035
Idaho,16041 ,Franklin County,5845,657,6664,5188,0.87710084,0.098589436,0.778511405
Idaho,16043 ,Fremont County,5548,998,6719,4550,0.825718113,0.148534008,0.677184105
Idaho,16045 ,Gem County,7951,1803,9958,6148,0.798453505,0.181060454,0.617393051
Idaho,16047 ,Gooding County,4659,1256,6050,3403,0.770082645,0.207603306,0.562479339
Idaho,16049 ,Idaho County,7826,1561,9602,6265,0.815038534,0.162570298,0.652468236
Idaho,16051 ,Jefferson County,12099,1661,14173,10438,0.85366542,0.117194666,0.736470754
Idaho,16053 ,Jerome County,5734,1893,7812,3841,0.733998976,0.242319508,0.491679467
Idaho,16055 ,Kootenai County,62837,24312,89878,38525,0.699136607,0.270500011,0.428636596
Idaho,16057 ,Latah County,9472,10236,20570,-764,0.460476422,0.49761789,-0.037141468
Idaho,16059 ,Lemhi County,3592,1032,4738,2560,0.758125791,0.217813423,0.540312368
Idaho,16061 ,Lewis County,1489,349,1870,1140,0.796256684,0.186631016,0.609625668
Idaho,16063 ,Lincoln County,1469,414,1940,1055,0.757216495,0.213402062,0.543814433
Idaho,16065 ,Madison County,13559,2666,17112,10893,0.792367929,0.155797101,0.636570827
Idaho,16067 ,Minidoka County,6265,1550,7993,4715,0.783810834,0.19391968,0.589891155
Idaho,16069 ,Nez Perce County,13738,6686,20967,7052,0.655220108,0.318882053,0.336338055
Idaho,16071 ,Oneida County,2148,249,2451,1899,0.876376989,0.101591187,0.774785802
Idaho,16073 ,Owyhee County,3819,816,4742,3003,0.80535639,0.172079291,0.633277098
Idaho,16075 ,Payette County,8862,2161,11293,6701,0.784733906,0.191357478,0.593376428
Idaho,16077 ,Power County,2116,865,3086,1251,0.685677252,0.280298121,0.405379132
Idaho,16079 ,Shoshone County,4216,1693,6049,2523,0.696974707,0.279880972,0.417093735
Idaho,16081 ,Teton County,2858,3318,6347,-460,0.450291476,0.522766661,-0.072475185
Idaho,16083 ,Twin Falls County,25897,9391,36680,16506,0.706025082,0.256025082,0.45
Idaho,16085 ,Valley County,3947,2976,7063,971,0.558827694,0.421350701,0.137476993
Idaho,16087 ,Washington County,4154,1073,5344,3081,0.777320359,0.200785928,0.576534431
Illinois,17001 ,Adams County,24131,8569,33434,15562,0.721750314,0.256295986,0.465454328
Illinois,17003 ,Alexander County,1486,1114,2625,372,0.566095238,0.424380952,0.141714286
Illinois,17005 ,Bond County,5612,2275,8109,3337,0.692070539,0.280552473,0.411518066
Illinois,17007 ,Boone County,13762,10372,24672,3390,0.557798314,0.42039559,0.137402724
Illinois,17009 ,Brown County,1930,485,2523,1445,0.764962346,0.19223147,0.572730876
Illinois,17011 ,Bureau County,10296,6545,17182,3751,0.599231754,0.380921895,0.218309859
Illinois,17013 ,Calhoun County,2043,674,2767,1369,0.738344778,0.24358511,0.494759668
Illinois,17015 ,Carroll County,5098,2737,8006,2361,0.636772421,0.341868599,0.294903822
Illinois,17017 ,Cass County,3624,1615,5325,2009,0.68056338,0.303286385,0.377276995
Illinois,17019 ,Champaign County,35122,56596,94911,-21474,0.370051943,0.596306013,-0.22625407
Illinois,17021 ,Christian County,11505,4286,16094,7219,0.714862682,0.266310426,0.448552255
Illinois,17023 ,Clark County,6215,1990,8340,4225,0.745203837,0.238609113,0.506594724
Illinois,17025 ,Clay County,5626,1129,6896,4497,0.815835267,0.163718097,0.652117169
Illinois,17027 ,Clinton County,14264,4459,19139,9805,0.745284498,0.23297978,0.512304718
Illinois,17029 ,Coles County,13981,7997,22470,5984,0.622207388,0.355896751,0.266310636
Illinois,17031 ,Cook County,558269,1725973,2321399,-1167704,0.240488171,0.743505533,-0.503017362
Illinois,17033 ,Crawford County,7025,2198,9419,4827,0.745832891,0.233358106,0.512474785
Illinois,17035 ,Cumberland County,4595,1141,5843,3454,0.78641109,0.195276399,0.591134691
Illinois,17037 ,DeKalb County,21905,24643,47989,-2738,0.456458772,0.513513514,-0.057054742
Illinois,17039 ,De Witt County,5623,2171,7994,3452,0.703402552,0.271578684,0.431823868
Illinois,17041 ,Douglas County,6221,2327,8746,3894,0.711296593,0.266064487,0.445232106
Illinois,17043 ,DuPage County,193611,281222,485064,-87611,0.399145267,0.57976267,-0.180617403
Illinois,17045 ,Edgar County,6169,1869,8152,4300,0.756746811,0.229268891,0.52747792
Illinois,17047 ,Edwards County,2833,488,3368,2345,0.841152019,0.144893112,0.696258907
Illinois,17049 ,Effingham County,14983,3700,19041,11283,0.786880941,0.194317525,0.592563416
Illinois,17051 ,Fayette County,8025,1815,10033,6210,0.79986046,0.18090302,0.61895744
Illinois,17053 ,Ford County,4956,1691,6809,3265,0.727860185,0.248347775,0.47951241
Illinois,17055 ,Franklin County,13514,4690,18488,8824,0.730960623,0.253678061,0.477282562
Illinois,17057 ,Fulton County,9798,6371,16517,3427,0.593206999,0.3857238,0.207483199
Illinois,17059 ,Gallatin County,2019,621,2673,1398,0.755331089,0.232323232,0.523007856
Illinois,17061 ,Greene County,4767,1349,6224,3418,0.76590617,0.216741645,0.549164524
Illinois,17063 ,Grundy County,16372,9445,26400,6927,0.620151515,0.357765152,0.262386364
Illinois,17065 ,Hamilton County,3429,821,4316,2608,0.794485635,0.190222428,0.604263207
Illinois,17067 ,Hancock County,5309,1114,6565,4195,0.808682407,0.169687738,0.638994669
Illinois,17069 ,Hardin County,0,0,0,0,0,0,0
Illinois,17071 ,Henderson County,2391,1186,3652,1205,0.654709748,0.32475356,0.329956188
Illinois,17073 ,Henry County,15266,9762,25624,5504,0.595769591,0.380970965,0.214798626
Illinois,17075 ,Iroquois County,10858,2895,14011,7963,0.774962529,0.206623367,0.568339162
Illinois,17077 ,Jackson County,10835,11104,22575,-269,0.479955703,0.491871539,-0.011915836
Illinois,17079 ,Jasper County,4492,1006,5582,3486,0.804729488,0.180222143,0.624507345
Illinois,17081 ,Jefferson County,12461,4597,17409,7864,0.715779195,0.26405882,0.451720375
Illinois,17083 ,Jersey County,8699,2956,11942,5743,0.728437448,0.247529727,0.480907721
Illinois,17085 ,Jo Daviess County,7161,5097,12477,2064,0.573936042,0.408511661,0.165424381
Illinois,17087 ,Johnson County,5052,1280,6442,3772,0.7842285,0.198696057,0.585532443
Illinois,17089 ,Kane County,96775,130166,231876,-33391,0.417356691,0.561360382,-0.144003692
Illinois,17091 ,Kankakee County,28410,20112,49729,8298,0.571296427,0.404432022,0.166864405
Illinois,17093 ,Kendall County,29492,33168,64205,-3676,0.459341173,0.516595281,-0.057254108
Illinois,17095 ,Knox County,11818,10421,22716,1397,0.520250044,0.458751541,0.061498503
Illinois,17097 ,Lake County,123594,204032,334156,-80438,0.369869163,0.610589066,-0.240719903
Illinois,17099 ,LaSalle County,29482,21491,52053,7991,0.566384262,0.412867654,0.153516608
Illinois,17101 ,Lawrence County,4849,1414,6379,3435,0.760150494,0.221664838,0.538485656
Illinois,17103 ,Lee County,9584,6368,16351,3216,0.58614152,0.389456302,0.196685218
Illinois,17105 ,Livingston County,12134,4568,17049,7566,0.711713297,0.267933603,0.443779694
Illinois,17107 ,Logan County,9042,3769,13117,5273,0.689334451,0.287337044,0.401997408
Illinois,17109 ,McDonough County,7009,4973,12290,2036,0.570301058,0.404637917,0.165663141
Illinois,17111 ,McHenry County,82257,78153,164574,4104,0.499817711,0.474880601,0.02493711
Illinois,17113 ,McLean County,40365,43719,87013,-3354,0.463896199,0.502442164,-0.038545964
Illinois,17115 ,Macon County,28373,19633,48934,8740,0.579821801,0.40121388,0.178607921
Illinois,17117 ,Macoupin County,16058,7313,23919,8745,0.671349137,0.305740207,0.36560893
Illinois,17119 ,Madison County,75272,56845,135686,18427,0.554751411,0.418945212,0.1358062
Illinois,17121 ,Marion County,12540,4396,17214,8144,0.728476821,0.255373533,0.473103288
Illinois,17123 ,Marshall County,4196,2004,6343,2192,0.661516633,0.31593883,0.345577802
Illinois,17125 ,Mason County,4645,1984,6756,2661,0.687537004,0.29366489,0.393872114
Illinois,17127 ,Massac County,4989,1719,6803,3270,0.733352933,0.25268264,0.480670293
Illinois,17129 ,Menard County,4764,2022,6954,2742,0.685073339,0.290767903,0.394305436
Illinois,17131 ,Mercer County,5328,3212,8750,2116,0.608914286,0.367085714,0.241828571
Illinois,17133 ,Monroe County,14046,6489,21024,7557,0.668093607,0.30864726,0.359446347
Illinois,17135 ,Montgomery County,9504,3889,13701,5615,0.693671995,0.283847894,0.4098241
Illinois,17137 ,Morgan County,9903,5020,15229,4883,0.650272506,0.32963425,0.320638256
Illinois,17139 ,Moultrie County,4938,1645,6698,3293,0.737234996,0.2455957,0.491639295
Illinois,17141 ,Ogle County,16092,9300,26040,6792,0.61797235,0.357142857,0.260829493
Illinois,17143 ,Peoria County,37612,42600,82264,-4988,0.457210931,0.517844987,-0.060634056
Illinois,17145 ,Perry County,7305,2609,10060,4696,0.726143141,0.259343936,0.466799205
Illinois,17147 ,Piatt County,6219,3302,9791,2917,0.635175161,0.337248494,0.297926667
Illinois,17149 ,Pike County,6235,1458,7836,4777,0.795686575,0.186064319,0.609622256
Illinois,17151 ,Pope County,1720,432,2172,1288,0.791896869,0.198895028,0.593001842
Illinois,17153 ,Pulaski County,1699,891,2631,808,0.645762068,0.338654504,0.307107564
Illinois,17155 ,Putnam County,1978,1309,3345,669,0.591330344,0.391330344,0.2
Illinois,17157 ,Randolph County,11065,3590,14896,7475,0.742816864,0.241004296,0.501812567
Illinois,17159 ,Richland County,7988,1355,9343,6633,0.854971637,0.145028363,0.709943273
Illinois,17161 ,Rock Island County,28585,36647,66750,-8062,0.4282397,0.549018727,-0.120779026
Illinois,17163 ,St. Clair County,56000,66698,125220,-10698,0.447212905,0.532646542,-0.085433637
Illinois,17165 ,Saline County,8096,2786,11079,5310,0.730751873,0.251466739,0.479285134
Illinois,17167 ,Sangamon County,53303,48756,104395,4547,0.510589588,0.467033862,0.043555726
Illinois,17169 ,Schuyler County,2767,1064,3908,1703,0.7080348,0.272262027,0.435772774
Illinois,17171 ,Scott County,2104,569,2730,1535,0.770695971,0.208424908,0.562271062
Illinois,17173 ,Shelby County,9396,2488,12049,6908,0.779815752,0.206490165,0.573325587
Illinois,17175 ,Stark County,2000,814,2881,1186,0.694203402,0.282540784,0.411662617
Illinois,17177 ,Stephenson County,12253,8756,21446,3497,0.571341975,0.408281265,0.163060711
Illinois,17179 ,Tazewell County,42194,24486,68358,17708,0.617250358,0.358202405,0.259047953
Illinois,17181 ,Union County,6157,2575,8896,3582,0.692108813,0.289455935,0.402652878
Illinois,17183 ,Vermilion County,20710,10313,31617,10397,0.655027359,0.32618528,0.328842079
Illinois,17185 ,Wabash County,4228,1248,5592,2980,0.756080114,0.223175966,0.532904149
Illinois,17187 ,Warren County,4671,3087,7916,1584,0.590070743,0.389969682,0.200101061
Illinois,17189 ,Washington County,6110,1639,7914,4471,0.772049532,0.207101339,0.564948193
Illinois,17191 ,Wayne County,7172,1185,8492,5987,0.844559585,0.139543099,0.705016486
Illinois,17193 ,White County,5788,1517,7428,4271,0.779213786,0.204227248,0.574986537
Illinois,17195 ,Whiteside County,14472,12195,27254,2277,0.531004623,0.447457254,0.083547369
Illinois,17197 ,Will County,155004,183903,346141,-28899,0.447805952,0.53129505,-0.083489098
Illinois,17199 ,Williamson County,22681,10107,33503,12574,0.676984151,0.301674477,0.375309674
Illinois,17201 ,Winnebago County,60861,64056,127710,-3195,0.47655626,0.501573878,-0.025017618
Illinois,17203 ,Woodford County,14590,5976,21079,8614,0.692158072,0.28350491,0.408653162
Indiana,18001 ,Adams County,10685,3236,14238,7449,0.750456525,0.227279112,0.523177413
Indiana,18003 ,Allen County,92083,73189,169000,18894,0.544869822,0.433071006,0.111798817
Indiana,18005 ,Bartholomew County,22409,12934,36299,9475,0.61734483,0.356318356,0.261026475
Indiana,18007 ,Benton County,3007,1009,4115,1998,0.730741191,0.245200486,0.485540705
Indiana,18009 ,Blackford County,3838,1376,5354,2462,0.716847217,0.257004109,0.459843108
Indiana,18011 ,Boone County,22351,15244,38500,7107,0.580545455,0.395948052,0.184597403
Indiana,18013 ,Brown County,5777,3036,8981,2741,0.643246854,0.338046988,0.305199866
Indiana,18015 ,Carroll County,7086,2224,9514,4862,0.744797141,0.233760774,0.511036367
Indiana,18017 ,Cass County,10552,4304,15189,6248,0.694713279,0.28336296,0.411350319
Indiana,18019 ,Clark County,33656,23088,58040,10568,0.579875948,0.397794624,0.182081323
Indiana,18021 ,Clay County,9498,2549,12277,6949,0.773641769,0.207624012,0.566017757
Indiana,18023 ,Clinton County,9334,3361,12961,5973,0.720160481,0.259316411,0.460844071
Indiana,18025 ,Crawford County,3499,1369,4975,2130,0.703316583,0.275175879,0.428140704
Indiana,18027 ,Daviess County,9576,2169,11971,7407,0.799933172,0.181187871,0.618745301
Indiana,18029 ,Dearborn County,19528,5446,25361,14082,0.770001183,0.214739166,0.555262016
Indiana,18031 ,Decatur County,9570,2436,12296,7134,0.778301887,0.198113208,0.580188679
Indiana,18033 ,DeKalb County,14237,4966,19656,9271,0.724308099,0.252645503,0.471662597
Indiana,18035 ,Delaware County,26827,20474,48191,6353,0.556680708,0.424851113,0.131829595
Indiana,18037 ,Dubois County,15032,6292,21805,8740,0.689383169,0.28855767,0.400825499
Indiana,18039 ,Elkhart County,46972,26108,74321,20864,0.632015177,0.351286985,0.280728193
Indiana,18041 ,Fayette County,7755,2237,10146,5518,0.764340627,0.220480978,0.543859649
Indiana,18043 ,Floyd County,23400,17511,41761,5889,0.56033141,0.419314672,0.141016738
Indiana,18045 ,Fountain County,6154,1629,7983,4525,0.770888137,0.204058625,0.566829513
Indiana,18047 ,Franklin County,9691,2137,12018,7554,0.806373773,0.177816608,0.628557164
Indiana,18049 ,Fulton County,6694,2280,9144,4414,0.732064742,0.249343832,0.48272091
Indiana,18051 ,Gibson County,11817,4027,16165,7790,0.731023817,0.249118466,0.481905351
Indiana,18053 ,Grant County,18543,8015,27230,10528,0.680976864,0.294344473,0.386632391
Indiana,18055 ,Greene County,11103,3389,14782,7714,0.751116222,0.229265323,0.5218509
Indiana,18057 ,Hamilton County,101587,88390,193871,13197,0.523992758,0.455921721,0.068071037
Indiana,18059 ,Hancock County,28996,12895,42907,16101,0.675787168,0.300533712,0.375253455
Indiana,18061 ,Harrison County,14565,5343,20231,9222,0.719934754,0.264099649,0.455835105
Indiana,18063 ,Hendricks County,53802,32604,88458,21198,0.608220851,0.3685817,0.239639151
Indiana,18065 ,Henry County,15043,5544,21021,9499,0.715617716,0.263736264,0.451881452
Indiana,18067 ,Howard County,26400,13270,40619,13130,0.649942145,0.326694404,0.323247741
Indiana,18069 ,Huntington County,13147,4255,17810,8892,0.738180797,0.238910724,0.499270073
Indiana,18071 ,Jackson County,14555,4302,19238,10253,0.756575528,0.223619919,0.532955609
Indiana,18073 ,Jasper County,11383,3798,15495,7585,0.734624072,0.245111326,0.489512746
Indiana,18075 ,Jay County,6361,1926,8466,4435,0.751358375,0.227498228,0.523860146
Indiana,18077 ,Jefferson County,9659,4731,14725,4928,0.655959253,0.321290323,0.33466893
Indiana,18079 ,Jennings County,9490,2523,12251,6967,0.774630642,0.205942372,0.56868827
Indiana,18081 ,Johnson County,51209,24729,77784,26480,0.658348761,0.317918852,0.340429908
Indiana,18083 ,Knox County,11654,4067,16027,7587,0.727147938,0.253759281,0.473388657
Indiana,18085 ,Kosciusko County,26476,8350,35846,18126,0.738604028,0.232940914,0.505663114
Indiana,18087 ,LaGrange County,8110,2355,10633,5755,0.762719834,0.221480297,0.541239537
Indiana,18089 ,Lake County,91733,124801,220233,-33068,0.416527042,0.56667711,-0.150150068
Indiana,18091 ,LaPorte County,25991,22419,49469,3572,0.525399745,0.453192909,0.072206837
Indiana,18093 ,Lawrence County,15601,4961,21071,10640,0.7404015,0.235442077,0.504959423
Indiana,18095 ,Madison County,31215,19524,51765,11691,0.603013619,0.377166039,0.22584758
Indiana,18097 ,Marion County,133968,247265,390405,-113297,0.343151343,0.633355106,-0.290203763
Indiana,18099 ,Marshall County,13844,5712,19918,8132,0.695049704,0.286775781,0.408273923
Indiana,18101 ,Martin County,4029,1011,5155,3018,0.78157129,0.196120272,0.585451018
Indiana,18103 ,Miami County,10925,3235,14493,7690,0.753812185,0.223211205,0.53060098
Indiana,18105 ,Monroe County,22071,39861,63037,-17790,0.350127703,0.63234291,-0.282215207
Indiana,18107 ,Montgomery County,12659,4213,17198,8446,0.736073962,0.244970345,0.491103617
Indiana,18109 ,Morgan County,27510,7777,36214,19733,0.759650964,0.214751201,0.544899763
Indiana,18111 ,Newton County,4942,1509,6591,3433,0.749810347,0.228948566,0.520861781
Indiana,18113 ,Noble County,14195,4660,19217,9535,0.738668887,0.242493625,0.496175261
Indiana,18115 ,Ohio County,2392,750,3164,1642,0.756005057,0.237041719,0.518963338
Indiana,18117 ,Orange County,6432,2224,8830,4208,0.728425821,0.25186863,0.476557191
Indiana,18119 ,Owen County,7285,2419,9915,4866,0.734745335,0.243973777,0.490771558
Indiana,18121 ,Parke County,5398,1503,7020,3895,0.768945869,0.214102564,0.554843305
Indiana,18123 ,Perry County,5343,3202,8734,2141,0.611747195,0.366613236,0.245133959
Indiana,18125 ,Pike County,4692,1415,6220,3277,0.754340836,0.227491961,0.526848875
Indiana,18127 ,Porter County,45008,39746,86410,5262,0.520865641,0.459969911,0.06089573
Indiana,18129 ,Posey County,9206,3811,13264,5395,0.694059107,0.287319059,0.406740048
Indiana,18131 ,Pulaski County,4246,1463,5813,2783,0.730431791,0.251677275,0.478754516
Indiana,18133 ,Putnam County,12278,3946,16595,8332,0.739861404,0.237782465,0.502078939
Indiana,18135 ,Randolph County,8312,2512,11078,5800,0.750315942,0.226755732,0.523560209
Indiana,18137 ,Ripley County,11261,2774,14264,8487,0.789469994,0.194475603,0.594994391
Indiana,18139 ,Rush County,6035,1754,7932,4281,0.760842158,0.221129602,0.539712557
Indiana,18141 ,St. Joseph County,53152,59870,115547,-6718,0.460003289,0.518144132,-0.058140843
Indiana,18143 ,Scott County,7328,2698,10176,4630,0.720125786,0.265133648,0.454992138
Indiana,18145 ,Shelby County,14568,5023,20017,9545,0.727781386,0.250936704,0.476844682
Indiana,18147 ,Spencer County,7354,3208,10781,4146,0.682125962,0.297560523,0.384565439
Indiana,18149 ,Starke County,7466,2650,10309,4816,0.724221554,0.257056941,0.467164613
Indiana,18151 ,Steuben County,11322,4509,16175,6813,0.699969088,0.278763524,0.421205564
Indiana,18153 ,Sullivan County,6687,2153,9004,4534,0.742669924,0.239115948,0.503553976
Indiana,18155 ,Switzerland County,3133,964,4152,2169,0.754576108,0.232177264,0.522398844
Indiana,18157 ,Tippecanoe County,34581,35017,71430,-436,0.484124318,0.490228195,-0.006103878
Indiana,18159 ,Tipton County,6110,1834,8124,4276,0.752092565,0.225750862,0.526341704
Indiana,18161 ,Union County,2687,736,3491,1951,0.769693498,0.210827843,0.558865655
Indiana,18163 ,Vanderburgh County,41844,34415,77581,7429,0.539358864,0.443600882,0.095757982
Indiana,18165 ,Vermillion County,5184,2145,7480,3039,0.693048128,0.286764706,0.406283422
Indiana,18167 ,Vigo County,24512,18080,43593,6432,0.562292111,0.414745487,0.147546624
Indiana,18169 ,Wabash County,10762,3494,14598,7268,0.737224277,0.239347856,0.497876421
Indiana,18171 ,Warren County,3401,974,4473,2427,0.760339817,0.21775095,0.542588867
Indiana,18173 ,Warrick County,21324,11919,33884,9405,0.629323575,0.351758942,0.277564632
Indiana,18175 ,Washington County,9114,2784,12131,6330,0.751298327,0.229494683,0.521803644
Indiana,18177 ,Wayne County,17567,9524,27662,8043,0.635058926,0.344299038,0.290759887
Indiana,18179 ,Wells County,10855,2928,14080,7927,0.770951705,0.207954545,0.562997159
Indiana,18181 ,White County,7957,3032,11159,4925,0.713056726,0.271708934,0.441347791
Indiana,18183 ,Whitley County,12856,4233,17581,8623,0.731243957,0.240771287,0.490472669
Iowa,19001 ,Adair County,2917,1197,4183,1720,0.697346402,0.28615826,0.411188142
Iowa,19003 ,Adams County,1528,590,2158,938,0.708063021,0.273401297,0.434661724
Iowa,19005 ,Allamakee County,4733,2575,7459,2158,0.634535461,0.345220539,0.289314922
Iowa,19007 ,Appanoose County,4512,1891,6506,2621,0.69351368,0.29065478,0.402858899
Iowa,19009 ,Audubon County,2295,1071,3416,1224,0.671838407,0.31352459,0.358313817
Iowa,19011 ,Benton County,9179,5156,14627,4023,0.627538114,0.352498804,0.275039311
Iowa,19013 ,Black Hawk County,29623,35621,66549,-5998,0.445130656,0.535259733,-0.090129078
Iowa,19015 ,Boone County,8695,6303,15306,2392,0.568077878,0.411799294,0.156278584
Iowa,19017 ,Bremer County,8287,5954,14534,2333,0.570180267,0.409660107,0.16052016
Iowa,19019 ,Buchanan County,6420,4169,10764,2251,0.596432553,0.38730955,0.209123003
Iowa,19021 ,Buena Vista County,5056,2961,8149,2095,0.620444226,0.363357467,0.257086759
Iowa,19023 ,Butler County,5542,2424,8084,3118,0.685551707,0.299851559,0.385700148
Iowa,19025 ,Calhoun County,3689,1470,5249,2219,0.702800533,0.280053343,0.42274719
Iowa,19027 ,Carroll County,7737,3454,11306,4283,0.684326906,0.305501504,0.378825402
Iowa,19029 ,Cass County,4969,2201,7266,2768,0.68387008,0.302917699,0.380952381
Iowa,19031 ,Cedar County,6161,4337,10703,1824,0.575633,0.405213492,0.170419509
Iowa,19033 ,Cerro Gordo County,12435,10941,23794,1494,0.522610742,0.459821804,0.062788938
Iowa,19035 ,Cherokee County,4495,1936,6503,2559,0.691219437,0.29770875,0.393510687
Iowa,19037 ,Chickasaw County,4308,2233,6617,2075,0.651050325,0.337464108,0.313586217
Iowa,19039 ,Clarke County,3140,1466,4666,1674,0.672953279,0.314187741,0.358765538
Iowa,19041 ,Clay County,6137,2662,8948,3475,0.685851587,0.297496647,0.38835494
Iowa,19043 ,Clayton County,6106,3340,9581,2766,0.637302996,0.348606617,0.288696378
Iowa,19045 ,Clinton County,13349,10806,24669,2543,0.541124488,0.438039645,0.103084843
Iowa,19047 ,Crawford County,4854,2220,7146,2634,0.679261125,0.310663308,0.368597817
Iowa,19049 ,Dallas County,27987,26879,55847,1108,0.501137035,0.481297115,0.01983992
Iowa,19051 ,Davis County,3032,1013,4099,2019,0.739692608,0.247133447,0.492559161
Iowa,19053 ,Decatur County,2615,1120,3801,1495,0.687976848,0.2946593,0.393317548
Iowa,19055 ,Delaware County,6666,3157,9981,3509,0.667868951,0.316300972,0.351567979
Iowa,19057 ,Des Moines County,10589,8887,19947,1702,0.53085677,0.445530656,0.085326114
Iowa,19059 ,Dickinson County,7438,3661,11230,3777,0.662333037,0.326001781,0.336331256
Iowa,19061 ,Dubuque County,27214,25655,53924,1559,0.504673244,0.475762184,0.02891106
Iowa,19063 ,Emmet County,3265,1520,4850,1745,0.673195876,0.313402062,0.359793814
Iowa,19065 ,Fayette County,6145,3834,10184,2311,0.603397486,0.376472899,0.226924588
Iowa,19067 ,Floyd County,4730,3168,8026,1562,0.589334662,0.394717169,0.194617493
Iowa,19069 ,Franklin County,3422,1626,5119,1796,0.668489939,0.317640164,0.350849775
Iowa,19071 ,Fremont County,2711,1078,3855,1633,0.703242542,0.279636835,0.423605707
Iowa,19073 ,Greene County,3221,1768,5054,1453,0.637316977,0.349821923,0.287495053
Iowa,19075 ,Grundy County,4929,2206,7260,2723,0.67892562,0.303856749,0.375068871
Iowa,19077 ,Guthrie County,4272,1985,6369,2287,0.67074894,0.311665882,0.359083059
Iowa,19079 ,Hamilton County,4956,2842,8516,2114,0.581963363,0.333724753,0.24823861
Iowa,19081 ,Hancock County,4390,1683,6161,2707,0.712546665,0.27316994,0.439376725
Iowa,19083 ,Hardin County,5850,2976,8975,2874,0.651810585,0.331587744,0.320222841
Iowa,19085 ,Harrison County,5569,2440,8144,3129,0.683816306,0.299607073,0.384209234
Iowa,19087 ,Henry County,6507,3275,9964,3232,0.653050984,0.32868326,0.324367724
Iowa,19089 ,Howard County,3127,1772,4952,1355,0.631462036,0.357835218,0.273626817
Iowa,19091 ,Humboldt County,3819,1442,5321,2377,0.717722233,0.271001691,0.446720541
Iowa,19093 ,Ida County,2876,917,3845,1959,0.747984395,0.238491547,0.509492848
Iowa,19095 ,Iowa County,6009,3547,9716,2462,0.618464389,0.365067929,0.253396459
Iowa,19097 ,Jackson County,6940,4029,11118,2911,0.624212988,0.362385321,0.261827667
Iowa,19099 ,Jasper County,12082,7737,20181,4345,0.598681929,0.383380407,0.215301521
Iowa,19101 ,Jefferson County,4442,4314,8952,128,0.496201966,0.481903485,0.014298481
Iowa,19103 ,Johnson County,22925,59177,83570,-36252,0.274320929,0.708112959,-0.433792031
Iowa,19105 ,Jones County,6572,4213,10965,2359,0.599361605,0.384222526,0.215139079
Iowa,19107 ,Keokuk County,3797,1414,5291,2383,0.717633718,0.267246267,0.45038745
Iowa,19109 ,Kossuth County,6275,2696,9077,3579,0.691307701,0.297014432,0.394293269
Iowa,19111 ,Lee County,9763,6539,16721,3224,0.583876562,0.391065128,0.192811435
Iowa,19113 ,Linn County,53364,70874,127078,-17510,0.419931066,0.557720455,-0.137789389
Iowa,19115 ,Louisa County,3500,1726,5326,1774,0.657153586,0.324070597,0.333082989
Iowa,19117 ,Lucas County,3287,1284,4630,2003,0.709935205,0.277321814,0.432613391
Iowa,19119 ,Lyon County,5707,1067,6852,4640,0.832895505,0.155720957,0.677174548
Iowa,19121 ,Madison County,6507,3134,9806,3373,0.663573322,0.319600245,0.343973078
Iowa,19123 ,Mahaska County,8297,2894,11381,5403,0.729022054,0.254283455,0.474738599
Iowa,19125 ,Marion County,12657,6170,19217,6487,0.658635583,0.321069886,0.337565697
Iowa,19127 ,Marshall County,9564,8171,18122,1393,0.527756318,0.450888423,0.076867895
Iowa,19129 ,Mills County,5572,2500,8247,3072,0.675639627,0.303140536,0.372499091
Iowa,19131 ,Mitchell County,3677,2053,5815,1624,0.632330181,0.353052451,0.27927773
Iowa,19133 ,Monona County,3248,1407,4714,1841,0.689011455,0.298472635,0.390538821
Iowa,19135 ,Monroe County,2975,1078,4085,1897,0.728274174,0.263892289,0.464381885
Iowa,19137 ,Montgomery County,3659,1583,5320,2076,0.687781955,0.297556391,0.390225564
Iowa,19139 ,Muscatine County,10823,9372,20629,1451,0.524649765,0.454311891,0.070337874
Iowa,19141 ,O'Brien County,5861,1569,7541,4292,0.777217876,0.208062591,0.569155284
Iowa,19143 ,Osceola County,2688,600,3325,2088,0.808421053,0.180451128,0.627969925
Iowa,19145 ,Page County,5319,2086,7519,3233,0.7074079,0.277430509,0.429977391
Iowa,19147 ,Palo Alto County,3370,1519,4950,1851,0.680808081,0.306868687,0.373939394
Iowa,19149 ,Plymouth County,10492,3494,14165,6998,0.740698906,0.246664313,0.494034592
Iowa,19151 ,Pocahontas County,2825,932,3821,1893,0.739335253,0.243915205,0.495420047
Iowa,19153 ,Polk County,106800,146250,257991,-39450,0.413967929,0.56688024,-0.152912311
Iowa,19155 ,Pottawattamie County,26241,18570,45733,7671,0.573786981,0.406052522,0.167734459
Iowa,19157 ,Poweshiek County,5657,4306,10124,1351,0.558771237,0.425325958,0.133445279
Iowa,19159 ,Ringgold County,1964,708,2709,1256,0.724990772,0.261351052,0.463639719
Iowa,19161 ,Sac County,4061,1389,5527,2672,0.734756649,0.251311742,0.483444907
Iowa,19163 ,Scott County,43661,46890,92639,-3229,0.471302583,0.506158313,-0.03485573
Iowa,19165 ,Shelby County,4697,1959,6781,2738,0.692670698,0.288895443,0.403775254
Iowa,19167 ,Sioux County,15680,3019,18956,12661,0.82717873,0.159263558,0.667915172
Iowa,19169 ,Story County,20340,29175,50837,-8835,0.400102288,0.573893031,-0.173790743
Iowa,19171 ,Tama County,5303,3577,9026,1726,0.587524928,0.396299579,0.191225349
Iowa,19173 ,Taylor County,2463,746,3242,1717,0.759716225,0.230104874,0.529611351
Iowa,19175 ,Union County,4010,2061,6171,1949,0.649813644,0.333981526,0.315832118
Iowa,19177 ,Van Buren County,2859,875,3788,1984,0.754751848,0.230992608,0.52375924
Iowa,19179 ,Wapello County,9516,5821,15613,3695,0.60949209,0.372830334,0.236661756
Iowa,19181 ,Warren County,17738,12537,30955,5201,0.573025359,0.405007269,0.168018091
Iowa,19183 ,Washington County,6966,4558,11757,2408,0.592498086,0.387683933,0.204814153
Iowa,19185 ,Wayne County,2338,727,3103,1611,0.753464389,0.234289397,0.519174992
Iowa,19187 ,Webster County,10927,6604,17802,4323,0.613807437,0.370969554,0.242837883
Iowa,19189 ,Winnebago County,3707,2135,5951,1572,0.622920518,0.358763233,0.264157284
Iowa,19191 ,Winneshiek County,6235,5617,12036,618,0.518029246,0.466683283,0.051345962
Iowa,19193 ,Woodbury County,25736,18704,45172,7032,0.569733463,0.414061808,0.155671655
Iowa,19195 ,Worth County,2738,1596,4414,1142,0.620299048,0.361576801,0.258722247
Iowa,19197 ,Wright County,4136,1996,6242,2140,0.662608138,0.319769305,0.342838834
Kansas,20001 ,Allen County,4155,1559,5842,2596,0.711229031,0.266860664,0.444368367
Kansas,20003 ,Anderson County,2874,765,3720,2109,0.772580645,0.205645161,0.566935484
Kansas,20005 ,Atchison County,4826,2314,7312,2512,0.660010941,0.316466083,0.343544858
Kansas,20007 ,Barber County,1992,284,2313,1708,0.861219196,0.122784263,0.738434933
Kansas,20009 ,Barton County,8480,2302,10961,6178,0.773652039,0.210017334,0.563634705
Kansas,20011 ,Bourbon County,4910,1505,6550,3405,0.749618321,0.229770992,0.519847328
Kansas,20013 ,Brown County,3206,1088,4396,2118,0.729299363,0.247497725,0.481801638
Kansas,20015 ,Butler County,22250,9003,31946,13247,0.696487823,0.28181932,0.414668503
Kansas,20017 ,Chase County,1114,341,1478,773,0.753721245,0.230717185,0.52300406
Kansas,20019 ,Chautauqua County,1397,212,1634,1185,0.85495716,0.129742962,0.725214198
Kansas,20021 ,Cherokee County,6622,2163,8945,4459,0.740301845,0.241811068,0.498490777
Kansas,20023 ,Cheyenne County,1158,220,1400,938,0.827142857,0.157142857,0.67
Kansas,20025 ,Clark County,885,143,1048,742,0.844465649,0.136450382,0.708015267
Kansas,20027 ,Clay County,3129,883,4134,2246,0.756894049,0.213594582,0.543299468
Kansas,20029 ,Cloud County,3182,893,4174,2289,0.762338285,0.21394346,0.548394825
Kansas,20031 ,Coffey County,3407,928,4448,2479,0.76596223,0.208633094,0.557329137
Kansas,20033 ,Comanche County,745,126,904,619,0.824115044,0.139380531,0.684734513
Kansas,20035 ,Cowley County,9442,4171,13911,5271,0.67874344,0.299834663,0.378908777
Kansas,20037 ,Crawford County,9752,5971,16125,3781,0.604775194,0.370294574,0.23448062
Kansas,20039 ,Decatur County,1232,208,1458,1024,0.844993141,0.14266118,0.702331962
Kansas,20041 ,Dickinson County,7045,2040,9246,5005,0.761951114,0.220635951,0.541315163
Kansas,20043 ,Doniphan County,2949,678,3674,2271,0.802667392,0.184540011,0.618127382
Kansas,20045 ,Douglas County,16737,39436,57540,-22699,0.290875912,0.685366701,-0.394490789
Kansas,20047 ,Edwards County,1127,267,1413,860,0.797593772,0.18895966,0.608634112
Kansas,20049 ,Elk County,1130,191,1347,939,0.838901262,0.141796585,0.697104677
Kansas,20051 ,Ellis County,9569,3633,13501,5936,0.708762314,0.269091178,0.439671135
Kansas,20053 ,Ellsworth County,2106,646,2806,1460,0.750534569,0.230220955,0.520313614
Kansas,20055 ,Finney County,7079,4155,11466,2924,0.617390546,0.36237572,0.255014826
Kansas,20057 ,Ford County,5763,2926,8850,2837,0.651186441,0.330621469,0.320564972
Kansas,20059 ,Franklin County,8326,3623,12247,4703,0.679839961,0.29582755,0.384012411
Kansas,20061 ,Geary County,5193,3825,9311,1368,0.557727419,0.410804425,0.146922994
Kansas,20063 ,Gove County,1256,163,1433,1093,0.876482903,0.113747383,0.76273552
Kansas,20065 ,Graham County,1052,222,1302,830,0.807987711,0.170506912,0.637480799
Kansas,20067 ,Grant County,1910,497,2452,1413,0.778955954,0.20269168,0.576264274
Kansas,20069 ,Gray County,1871,337,2240,1534,0.835267857,0.150446429,0.684821429
Kansas,20071 ,Greeley County,537,77,629,460,0.853736089,0.122416534,0.731319555
Kansas,20073 ,Greenwood County,2404,562,3030,1842,0.79339934,0.185478548,0.607920792
Kansas,20075 ,Hamilton County,684,134,837,550,0.817204301,0.160095579,0.657108722
Kansas,20077 ,Harper County,2128,453,2626,1675,0.810357959,0.172505712,0.637852247
Kansas,20079 ,Harvey County,10015,6652,17034,3363,0.587941764,0.390513091,0.197428672
Kansas,20081 ,Haskell County,1103,261,1383,842,0.797541576,0.188720174,0.608821403
Kansas,20083 ,Hodgeman County,866,151,1033,715,0.838334947,0.146176186,0.692158761
Kansas,20085 ,Jackson County,4435,1852,6468,2583,0.685683364,0.286332715,0.399350649
Kansas,20087 ,Jefferson County,6193,3106,9581,3087,0.646383467,0.324183279,0.322200188
Kansas,20089 ,Jewell County,1369,211,1608,1158,0.851368159,0.131218905,0.720149254
Kansas,20091 ,Johnson County,151280,177925,336277,-26645,0.449867223,0.529102496,-0.079235273
Kansas,20093 ,Kearny County,1134,255,1413,879,0.802547771,0.180467091,0.622080679
Kansas,20095 ,Kingman County,3102,745,3929,2357,0.789513871,0.189615678,0.599898193
Kansas,20097 ,Kiowa County,957,153,1139,804,0.840210711,0.134328358,0.705882353
Kansas,20099 ,Labette County,5639,2607,8414,3032,0.670192536,0.309840742,0.360351795
Kansas,20101 ,Lane County,757,114,888,643,0.852477477,0.128378378,0.724099099
Kansas,20103 ,Leavenworth County,21378,13753,36115,7625,0.591942406,0.380811297,0.211131109
Kansas,20105 ,Lincoln County,1273,266,1570,1007,0.810828025,0.169426752,0.641401274
Kansas,20107 ,Linn County,3940,863,4903,3077,0.803589639,0.176014685,0.627574954
Kansas,20109 ,Logan County,1231,185,1437,1046,0.85664579,0.128740431,0.727905358
Kansas,20111 ,Lyon County,7381,5878,13622,1503,0.541844076,0.431507855,0.110336221
Kansas,20113 ,McPherson County,9562,3977,13868,5585,0.68950101,0.28677531,0.402725699
Kansas,20115 ,Marion County,4377,1463,5969,2914,0.733288658,0.245099682,0.488188976
Kansas,20117 ,Marshall County,3662,1239,5023,2423,0.729046387,0.246665339,0.482381047
Kansas,20119 ,Meade County,1508,261,1807,1247,0.834532374,0.144438296,0.690094079
Kansas,20121 ,Miami County,12116,5133,17624,6983,0.68747163,0.291250567,0.396221062
Kansas,20123 ,Mitchell County,2454,547,3039,1907,0.807502468,0.179993419,0.627509049
Kansas,20125 ,Montgomery County,9768,3147,13177,6621,0.741291645,0.238825226,0.502466419
Kansas,20127 ,Morris County,2085,721,2849,1364,0.731835732,0.253071253,0.478764479
Kansas,20129 ,Morton County,1004,147,1163,857,0.863284609,0.126397248,0.73688736
Kansas,20131 ,Nemaha County,4612,920,5625,3692,0.819911111,0.163555556,0.656355556
Kansas,20133 ,Neosho County,4795,1727,6629,3068,0.723336853,0.260521949,0.462814904
Kansas,20135 ,Ness County,1315,147,1487,1168,0.884330868,0.098856759,0.785474109
Kansas,20137 ,Norton County,1977,361,2390,1616,0.827196653,0.151046025,0.676150628
Kansas,20139 ,Osage County,5591,2099,7893,3492,0.70834917,0.265931838,0.442417332
Kansas,20141 ,Osborne County,1590,275,1899,1315,0.83728278,0.14481306,0.692469721
Kansas,20143 ,Ottawa County,2581,504,3159,2077,0.817030706,0.15954416,0.657486546
Kansas,20145 ,Pawnee County,2028,635,2712,1393,0.747787611,0.234144543,0.513643068
Kansas,20147 ,Phillips County,2388,318,2752,2070,0.867732558,0.115552326,0.752180233
Kansas,20149 ,Pottawatomie County,9247,3257,12815,5990,0.721576278,0.254155287,0.467420991
Kansas,20151 ,Pratt County,3087,924,4107,2163,0.751643535,0.224981738,0.526661797
Kansas,20153 ,Rawlins County,1253,214,1496,1039,0.837566845,0.143048128,0.694518717
Kansas,20155 ,Reno County,17948,8602,27245,9346,0.658763076,0.315727656,0.343035419
Kansas,20157 ,Republic County,2172,420,2643,1752,0.821793417,0.158910329,0.662883087
Kansas,20159 ,Rice County,3187,953,4230,2234,0.753427896,0.225295508,0.528132388
Kansas,20161 ,Riley County,11174,11940,23855,-766,0.468413331,0.500523999,-0.032110669
Kansas,20163 ,Rooks County,2294,332,2661,1962,0.862081924,0.124765126,0.737316798
Kansas,20165 ,Rush County,1425,291,1748,1134,0.815217391,0.166475973,0.648741419
Kansas,20167 ,Russell County,2765,591,3429,2174,0.806357539,0.172353456,0.634004083
Kansas,20169 ,Saline County,15313,8022,23911,7291,0.640416545,0.335494124,0.304922421
Kansas,20171 ,Scott County,1991,290,2322,1701,0.857450474,0.124892334,0.73255814
Kansas,20173 ,Sedgwick County,117653,90820,213552,26833,0.55093373,0.425282835,0.125650895
Kansas,20175 ,Seward County,3285,1736,5099,1549,0.644243969,0.340458914,0.303785056
Kansas,20177 ,Shawnee County,39890,42032,84061,-2142,0.474536349,0.500017844,-0.025481496
Kansas,20179 ,Sheridan County,1237,144,1397,1093,0.885468862,0.103078024,0.782390838
Kansas,20181 ,Sherman County,2222,386,2673,1836,0.83127572,0.144407033,0.686868687
Kansas,20183 ,Smith County,1734,328,2092,1406,0.828871893,0.156787763,0.67208413
Kansas,20185 ,Stafford County,1631,355,2017,1276,0.808626673,0.176003966,0.632622707
Kansas,20187 ,Stanton County,607,147,767,460,0.791395046,0.191655802,0.599739244
Kansas,20189 ,Stevens County,1731,233,1997,1498,0.8668002,0.116675013,0.750125188
Kansas,20191 ,Sumner County,7998,2551,10779,5447,0.74199833,0.236663883,0.505334447
Kansas,20193 ,Thomas County,3106,622,3794,2484,0.818661044,0.163943068,0.654717976
Kansas,20195 ,Trego County,1341,238,1603,1103,0.836556457,0.148471616,0.688084841
Kansas,20197 ,Wabaunsee County,2813,956,3861,1857,0.728567729,0.247604248,0.480963481
Kansas,20199 ,Wallace County,762,44,817,718,0.932680539,0.053855569,0.878824969
Kansas,20201 ,Washington County,2332,467,2843,1865,0.820260288,0.164263102,0.655997186
Kansas,20203 ,Wichita County,803,147,961,656,0.835587929,0.152965661,0.682622268
Kansas,20205 ,Wilson County,3111,711,3899,2400,0.797896897,0.18235445,0.615542447
Kansas,20207 ,Woodson County,1189,283,1495,906,0.795317726,0.189297659,0.606020067
Kansas,20209 ,Wyandotte County,18512,35566,55107,-17054,0.335928285,0.645398951,-0.309470666
Kentucky,21001 ,Adair County,7276,1392,8768,5884,0.829835766,0.158759124,0.671076642
Kentucky,21003 ,Allen County,7587,1642,9364,5945,0.810230671,0.175352413,0.634878257
Kentucky,21005 ,Anderson County,9661,3348,13254,6313,0.728912027,0.252602988,0.476309039
Kentucky,21007 ,Ballard County,3356,825,4225,2531,0.794319527,0.195266272,0.599053254
Kentucky,21009 ,Barren County,14654,5127,20064,9527,0.730362839,0.255532297,0.474830542
Kentucky,21011 ,Bath County,3986,1573,5627,2413,0.708370357,0.279545051,0.428825307
Kentucky,21013 ,Bell County,8140,1789,10044,6351,0.81043409,0.178116288,0.632317802
Kentucky,21015 ,Boone County,44814,20901,66998,23913,0.668885638,0.311964536,0.356921102
Kentucky,21017 ,Bourbon County,6190,3296,9648,2894,0.641583748,0.341625207,0.299958541
Kentucky,21019 ,Boyd County,14295,7083,21751,7212,0.657211163,0.3256402,0.331570962
Kentucky,21021 ,Boyle County,8872,5298,14478,3574,0.612791822,0.365934521,0.246857301
Kentucky,21023 ,Bracken County,3398,800,4246,2598,0.800282619,0.188412624,0.611869995
Kentucky,21025 ,Breathitt County,4265,1301,5661,2964,0.753400459,0.229818053,0.523582406
Kentucky,21027 ,Breckinridge County,7701,2350,10201,5351,0.754925988,0.230369572,0.524556416
Kentucky,21029 ,Bullitt County,30708,10552,41998,20156,0.731177675,0.25125006,0.479927616
Kentucky,21031 ,Butler County,4960,1079,6125,3881,0.809795918,0.176163265,0.633632653
Kentucky,21033 ,Caldwell County,4906,1433,6434,3473,0.762511657,0.222723034,0.539788623
Kentucky,21035 ,Calloway County,11352,5797,17457,5555,0.650283554,0.332073094,0.31821046
Kentucky,21037 ,Campbell County,28482,19374,48878,9108,0.58271615,0.396374647,0.186341503
Kentucky,21039 ,Carlisle County,2159,463,2638,1696,0.818423048,0.175511751,0.642911296
Kentucky,21041 ,Carroll County,2954,1116,4136,1838,0.714216634,0.269825919,0.444390716
Kentucky,21043 ,Carter County,8775,2642,11586,6133,0.757379596,0.228033834,0.529345762
Kentucky,21045 ,Casey County,6179,918,7171,5261,0.86166504,0.128015618,0.733649421
Kentucky,21047 ,Christian County,15080,8296,23863,6784,0.631940661,0.347651175,0.284289486
Kentucky,21049 ,Clark County,11811,6004,18139,5807,0.651138431,0.330999504,0.320138927
Kentucky,21051 ,Clay County,6677,831,7591,5846,0.879594256,0.109471743,0.770122514
Kentucky,21053 ,Clinton County,4280,603,4932,3677,0.867802109,0.122262774,0.745539335
Kentucky,21055 ,Crittenden County,3451,731,4242,2720,0.813531353,0.172324375,0.641206978
Kentucky,21057 ,Cumberland County,2769,508,3309,2261,0.836808704,0.153520701,0.683288002
Kentucky,21059 ,Daviess County,31025,17286,49287,13739,0.629476333,0.350721286,0.278755047
Kentucky,21061 ,Edmonson County,4828,1227,6132,3601,0.787345075,0.200097847,0.587247228
Kentucky,21063 ,Elliott County,2246,712,2995,1534,0.749916528,0.237729549,0.512186978
Kentucky,21065 ,Estill County,5100,1355,6540,3745,0.779816514,0.207186544,0.572629969
Kentucky,21067 ,Fayette County,58860,90600,152912,-31740,0.384927278,0.592497646,-0.207570367
Kentucky,21069 ,Fleming County,5534,1474,7068,4060,0.782965478,0.208545557,0.574419921
Kentucky,21071 ,Floyd County,12250,3884,16353,8366,0.749098025,0.237509937,0.511588088
Kentucky,21073 ,Franklin County,12900,12652,26072,248,0.494783676,0.485271556,0.00951212
Kentucky,21075 ,Fulton County,1606,794,2426,812,0.661995054,0.327287716,0.334707337
Kentucky,21077 ,Gallatin County,2955,822,3849,2133,0.767731878,0.213561964,0.554169914
Kentucky,21079 ,Garrard County,6754,1830,8706,4924,0.775786814,0.210199862,0.565586952
Kentucky,21081 ,Grant County,8725,2205,11108,6520,0.785469932,0.198505582,0.58696435
Kentucky,21083 ,Graves County,13206,3560,17019,9646,0.775956284,0.209177978,0.566778307
Kentucky,21085 ,Grayson County,9453,2400,11985,7053,0.78873592,0.200250313,0.588485607
Kentucky,21087 ,Green County,4838,920,5812,3918,0.832415692,0.158293187,0.674122505
Kentucky,21089 ,Greenup County,13064,4873,18176,8191,0.71875,0.268100792,0.450649208
Kentucky,21091 ,Hancock County,3145,1351,4587,1794,0.685633312,0.294528014,0.391105298
Kentucky,21093 ,Hardin County,29832,18101,48941,11731,0.609550275,0.369853497,0.239696778
Kentucky,21095 ,Harlan County,9367,1494,10971,7873,0.853796372,0.136177194,0.717619178
Kentucky,21097 ,Harrison County,6334,2400,8859,3934,0.714979117,0.270910938,0.444068179
Kentucky,21099 ,Hart County,6345,1908,8370,4437,0.758064516,0.227956989,0.530107527
Kentucky,21101 ,Henderson County,12730,7639,20697,5091,0.615064985,0.369087307,0.245977678
Kentucky,21103 ,Henry County,5843,2142,8110,3701,0.720468557,0.264118372,0.456350185
Kentucky,21105 ,Hickman County,1714,458,2199,1256,0.779445202,0.208276489,0.571168713
Kentucky,21107 ,Hopkins County,15757,5439,21512,10318,0.732474898,0.252835627,0.479639271
Kentucky,21109 ,Jackson County,5453,605,6113,4848,0.892033372,0.098969409,0.793063962
Kentucky,21111 ,Jefferson County,150646,228358,386629,-77712,0.38963968,0.590638571,-0.20099889
Kentucky,21113 ,Jessamine County,17096,8567,26280,8529,0.650532725,0.325989346,0.324543379
Kentucky,21115 ,Johnson County,8450,1608,10192,6842,0.829081633,0.157770801,0.671310832
Kentucky,21117 ,Kenton County,48129,32271,82198,15858,0.585525195,0.392600793,0.192924402
Kentucky,21119 ,Knott County,4780,1412,6252,3368,0.764555342,0.225847729,0.538707614
Kentucky,21121 ,Knox County,11012,2114,13273,8898,0.829654185,0.1592707,0.670383485
Kentucky,21123 ,Larue County,5685,1504,7301,4181,0.778660457,0.205999178,0.572661279
Kentucky,21125 ,Laurel County,23237,4475,28111,18762,0.826615915,0.159190353,0.667425563
Kentucky,21127 ,Lawrence County,5633,1238,6955,4395,0.80992092,0.178001438,0.631919482
Kentucky,21129 ,Lee County,2273,481,2801,1792,0.811495894,0.171724384,0.63977151
Kentucky,21131 ,Leslie County,4321,446,4813,3875,0.897776854,0.092665697,0.805111157
Kentucky,21133 ,Letcher County,7226,1799,9135,5427,0.791023536,0.196934866,0.59408867
Kentucky,21135 ,Lewis County,4986,823,5883,4163,0.847526772,0.139894612,0.70763216
Kentucky,21137 ,Lincoln County,8489,2254,10914,6235,0.77780832,0.206523731,0.571284589
Kentucky,21139 ,Livingston County,4010,939,5004,3071,0.801358913,0.18764988,0.613709033
Kentucky,21141 ,Logan County,9067,3094,12350,5973,0.73417004,0.250526316,0.483643725
Kentucky,21143 ,Lyon County,3100,1092,4228,2008,0.73320719,0.258278146,0.474929044
Kentucky,21145 ,McCracken County,21820,11195,33549,10625,0.650391964,0.333691019,0.316700945
Kentucky,21147 ,McCreary County,5664,725,6438,4939,0.879776328,0.112612613,0.767163715
Kentucky,21149 ,McLean County,3633,1074,4782,2559,0.759723965,0.224592221,0.535131744
Kentucky,21151 ,Madison County,27356,15581,43957,11775,0.622335464,0.35446004,0.267875424
Kentucky,21153 ,Magoffin County,4174,1214,5447,2960,0.766293372,0.222874977,0.543418395
Kentucky,21155 ,Marion County,6113,2722,8928,3391,0.684699821,0.304883513,0.379816308
Kentucky,21157 ,Marshall County,13297,4071,17603,9226,0.755382605,0.231267398,0.524115208
Kentucky,21159 ,Martin County,3496,403,3936,3093,0.888211382,0.102388211,0.785823171
Kentucky,21161 ,Mason County,5477,2362,7958,3115,0.688238251,0.296808243,0.391430008
Kentucky,21163 ,Meade County,10185,3632,14113,6553,0.721675051,0.257351378,0.464323673
Kentucky,21165 ,Menifee County,2311,750,3102,1561,0.745003224,0.241779497,0.503223727
Kentucky,21167 ,Mercer County,8506,3033,11735,5473,0.724840222,0.258457605,0.466382616
Kentucky,21169 ,Metcalfe County,3959,975,5012,2984,0.78990423,0.194533121,0.595371109
Kentucky,21171 ,Monroe County,4628,657,5330,3971,0.868292683,0.12326454,0.745028143
Kentucky,21173 ,Montgomery County,8993,3630,12842,5363,0.70028033,0.282666251,0.417614079
Kentucky,21175 ,Morgan County,4301,1175,5544,3126,0.775793651,0.211940837,0.563852814
Kentucky,21177 ,Muhlenberg County,10497,3545,14235,6952,0.737407798,0.249034071,0.488373727
Kentucky,21179 ,Nelson County,15703,7188,23256,8515,0.675223598,0.309081527,0.366142071
Kentucky,21181 ,Nicholas County,2408,955,3396,1453,0.709069494,0.281213192,0.427856302
Kentucky,21183 ,Ohio County,8582,2404,11129,6178,0.771138467,0.21601222,0.555126247
Kentucky,21185 ,Oldham County,22654,14505,37976,8149,0.596534653,0.381951759,0.214582894
Kentucky,21187 ,Owen County,4292,1098,5458,3194,0.786368633,0.201172591,0.585196043
Kentucky,21189 ,Owsley County,1671,216,1896,1455,0.881329114,0.113924051,0.767405063
Kentucky,21191 ,Pendleton County,5515,1322,6925,4193,0.796389892,0.190902527,0.605487365
Kentucky,21193 ,Perry County,8129,2356,10626,5773,0.765010352,0.221720309,0.543290043
Kentucky,21195 ,Pike County,20284,4866,25395,15418,0.798739909,0.191612522,0.607127387
Kentucky,21197 ,Powell County,4041,1367,5505,2674,0.734059946,0.248319709,0.485740236
Kentucky,21199 ,Pulaski County,25442,5666,31557,19776,0.806223659,0.179548119,0.626675539
Kentucky,21201 ,Robertson County,884,253,1146,631,0.771378709,0.220767888,0.55061082
Kentucky,21203 ,Rockcastle County,6577,1134,7784,5443,0.844938335,0.145683453,0.699254882
Kentucky,21205 ,Rowan County,5994,3880,10065,2114,0.595529061,0.385494287,0.210034774
Kentucky,21207 ,Russell County,7519,1331,8955,6188,0.839642658,0.148632049,0.691010609
Kentucky,21209 ,Scott County,17767,10567,28969,7200,0.61331078,0.364769236,0.248541544
Kentucky,21211 ,Shelby County,15055,8077,23550,6978,0.639278132,0.342972399,0.296305732
Kentucky,21213 ,Simpson County,5888,2681,8732,3207,0.67430142,0.307031608,0.367269812
Kentucky,21215 ,Spencer County,8737,2530,11433,6207,0.764191376,0.22128925,0.542902125
Kentucky,21217 ,Taylor County,9376,2963,12517,6413,0.749061277,0.236718063,0.512343213
Kentucky,21219 ,Todd County,4062,1205,5363,2857,0.757411896,0.224687675,0.532724222
Kentucky,21221 ,Trigg County,5487,1791,7376,3696,0.743899132,0.242814534,0.501084599
Kentucky,21223 ,Trimble County,3227,1012,4320,2215,0.746990741,0.234259259,0.512731481
Kentucky,21225 ,Union County,4965,1529,6577,3436,0.754903451,0.232476813,0.522426638
Kentucky,21227 ,Warren County,31791,22479,55401,9312,0.573834407,0.405750799,0.168083609
Kentucky,21229 ,Washington County,4482,1644,6225,2838,0.72,0.264096386,0.455903614
Kentucky,21231 ,Wayne County,7430,1700,9240,5730,0.804112554,0.183982684,0.62012987
Kentucky,21233 ,Webster County,4506,1412,5993,3094,0.75187719,0.23560821,0.51626898
Kentucky,21235 ,Whitley County,12567,2552,15356,10015,0.818377182,0.166189112,0.65218807
Kentucky,21237 ,Wolfe County,2097,839,2979,1258,0.703927492,0.281638134,0.422289359
Kentucky,21239 ,Woodford County,8362,6530,15211,1832,0.549733745,0.429294589,0.120439156
Louisiana,22001 ,Acadia Parish,22596,5443,28425,17153,0.794934037,0.191486368,0.603447669
Louisiana,22003 ,Allen Parish,7574,2108,9810,5466,0.772069317,0.214882773,0.557186544
Louisiana,22005 ,Ascension Parish,40687,20399,62325,20288,0.652819896,0.327300441,0.325519454
Louisiana,22007 ,Assumption Parish,7271,3833,11235,3438,0.64717401,0.341165999,0.306008011
Louisiana,22009 ,Avoyelles Parish,12028,4979,17292,7049,0.695581772,0.287936618,0.407645154
Louisiana,22011 ,Beauregard Parish,13575,2542,16357,11033,0.829919912,0.155407471,0.674512441
Louisiana,22013 ,Bienville Parish,3891,3067,7050,824,0.551914894,0.435035461,0.116879433
Louisiana,22015 ,Bossier Parish,38074,15662,54655,22412,0.69662428,0.286561156,0.410063123
Louisiana,22017 ,Caddo Parish,48021,55110,104912,-7089,0.457726476,0.525297392,-0.067570917
Louisiana,22019 ,Calcasieu Parish,55066,25982,82663,29084,0.666150515,0.314312328,0.351838186
Louisiana,22021 ,Caldwell Parish,3976,745,4762,3231,0.834943301,0.156446871,0.67849643
Louisiana,22023 ,Cameron Parish,3671,324,4039,3347,0.908888339,0.080217876,0.828670463
Louisiana,22025 ,Catahoula Parish,3541,1269,4858,2272,0.728900782,0.261218608,0.467682174
Louisiana,22027 ,Claiborne Parish,3770,2731,6580,1039,0.572948328,0.415045593,0.157902736
Louisiana,22029 ,Concordia Parish,5550,3177,8828,2373,0.628681468,0.359877662,0.268803806
Louisiana,22031 ,De Soto Parish,9112,5457,14736,3655,0.61834962,0.37031759,0.24803203
Louisiana,22033 ,East Baton Rouge Parish,88420,115577,208182,-27157,0.42472452,0.555172878,-0.130448358
Louisiana,22035 ,East Carroll Parish,1080,1900,3036,-820,0.355731225,0.625823452,-0.270092227
Louisiana,22037 ,East Feliciana Parish,6064,4280,10509,1784,0.577029213,0.407269959,0.169759254
Louisiana,22039 ,Evangeline Parish,11053,4158,15412,6895,0.71716844,0.269789774,0.447378666
Louisiana,22041 ,Franklin Parish,6970,2658,9720,4312,0.717078189,0.27345679,0.443621399
Louisiana,22043 ,Grant Parish,8117,1157,9392,6960,0.864246167,0.123189949,0.741056218
Louisiana,22045 ,Iberia Parish,21251,11027,32713,10224,0.649619417,0.337083117,0.312536301
Louisiana,22047 ,Iberville Parish,7893,8514,16719,-621,0.472097613,0.509240983,-0.03714337
Louisiana,22049 ,Jackson Parish,5394,2143,7632,3251,0.706761006,0.280791405,0.425969602
Louisiana,22051 ,Jefferson Parish,105949,84477,193733,21472,0.546881533,0.436048582,0.110832951
Louisiana,22053 ,Jefferson Davis Parish,11423,3208,14841,8215,0.769692069,0.216157941,0.553534128
Louisiana,22055 ,Lafayette Parish,72519,39685,114521,32834,0.633237572,0.346530331,0.286707241
Louisiana,22057 ,Lafourche Parish,36024,8672,45388,27352,0.793689962,0.191063717,0.602626245
Louisiana,22059 ,LaSalle Parish,6378,638,7077,5740,0.901229334,0.090151194,0.81107814
Louisiana,22061 ,Lincoln Parish,11311,7559,19275,3752,0.586822309,0.392166018,0.194656291
Louisiana,22063 ,Livingston Parish,54877,9249,65230,45628,0.841284685,0.141790587,0.699494098
Louisiana,22065 ,Madison Parish,1930,2654,4670,-724,0.413276231,0.568308351,-0.15503212
Louisiana,22067 ,Morehouse Parish,6510,4946,11574,1564,0.5624676,0.427337135,0.135130465
Louisiana,22069 ,Natchitoches Parish,9358,6896,16554,2462,0.565301438,0.416576054,0.148725384
Louisiana,22071 ,Orleans Parish,26664,147854,177819,-121190,0.14995023,0.831485949,-0.681535719
Louisiana,22073 ,Ouachita Parish,42255,25913,69166,16342,0.610921551,0.374649394,0.236272157
Louisiana,22075 ,Plaquemines Parish,7412,3414,11014,3998,0.672961685,0.30996913,0.362992555
Louisiana,22077 ,Pointe Coupee Parish,7503,4683,12371,2820,0.60649907,0.378546601,0.227952469
Louisiana,22079 ,Rapides Parish,38347,19475,58865,18872,0.651439735,0.330841757,0.320597978
Louisiana,22081 ,Red River Parish,2413,1644,4132,769,0.583978703,0.397870281,0.186108422
Louisiana,22083 ,Richland Parish,6607,3225,9940,3382,0.664688129,0.32444668,0.340241449
Louisiana,22085 ,Sabine Parish,8776,1731,10596,7045,0.828237071,0.163363533,0.664873537
Louisiana,22087 ,St. Bernard Parish,11179,6151,17650,5028,0.633371105,0.348498584,0.284872521
Louisiana,22089 ,St. Charles Parish,18233,9800,28517,8433,0.639373006,0.343654662,0.295718343
Louisiana,22091 ,St. Helena Parish,2714,3346,6158,-632,0.440727509,0.543358233,-0.102630724
Louisiana,22093 ,St. James Parish,5954,6510,12590,-556,0.472915012,0.517077045,-0.044162033
Louisiana,22095 ,St. John the Baptist Parish,7538,13582,21432,-6044,0.351717059,0.633725271,-0.282008212
Louisiana,22097 ,St. Landry Parish,23171,17372,41154,5799,0.56303154,0.422121786,0.140909754
Louisiana,22099 ,St. Martin Parish,18203,8439,27038,9764,0.673237666,0.312116281,0.361121385
Louisiana,22101 ,St. Mary Parish,14811,8055,23186,6756,0.63879065,0.347407919,0.291382731
Louisiana,22103 ,St. Tammany Parish,99666,37746,140110,61920,0.711341089,0.269402612,0.441938477
Louisiana,22105 ,Tangipahoa Parish,37806,18887,57661,18919,0.655659805,0.327552418,0.328107386
Louisiana,22107 ,Tensas Parish,1197,1329,2554,-132,0.468676586,0.520360219,-0.051683634
Louisiana,22109 ,Terrebonne Parish,34339,11198,46240,23141,0.742625433,0.24217128,0.500454152
Louisiana,22111 ,Union Parish,8407,2654,11201,5753,0.750557986,0.23694313,0.513614856
Louisiana,22113 ,Vermilion Parish,21930,5009,27324,16921,0.802591129,0.183318694,0.619272434
Louisiana,22115 ,Vernon Parish,14107,2898,17268,11209,0.816944637,0.167824878,0.649119759
Louisiana,22117 ,Washington Parish,13307,5970,19513,7337,0.681955619,0.30594988,0.37600574
Louisiana,22119 ,Webster Parish,11830,6172,18216,5658,0.649429073,0.338823013,0.310606061
Louisiana,22121 ,West Baton Rouge Parish,7684,6200,14097,1484,0.545080514,0.439809889,0.105270625
Louisiana,22123 ,West Carroll Parish,4317,710,5052,3607,0.854513064,0.140538401,0.713974663
Louisiana,22125 ,West Feliciana Parish,3863,2298,6268,1565,0.616305041,0.366624123,0.249680919
Louisiana,22127 ,Winn Parish,4619,1543,6225,3076,0.742008032,0.247871486,0.494136546
Maine,23001 ,Androscoggin County,29268,27617,58796,1651,0.497788965,0.469708824,0.028080142
Maine,23003 ,Aroostook County,22071,14884,37807,7187,0.583780781,0.393683709,0.190097072
Maine,23005 ,Cumberland County,59584,128759,194180,-69175,0.306849315,0.663090947,-0.356241631
Maine,23007 ,Franklin County,8737,8038,17433,699,0.501175931,0.461079562,0.040096369
Maine,23009 ,Hancock County,14975,19363,35380,-4388,0.42326173,0.547286603,-0.124024873
Maine,23011 ,Kennebec County,34721,34902,71899,-181,0.482913531,0.485430952,-0.00251742
Maine,23013 ,Knox County,9982,15110,25734,-5128,0.387891505,0.587160954,-0.199269449
Maine,23015 ,Lincoln County,10256,12684,23617,-2428,0.434263454,0.537070754,-0.1028073
Maine,23017 ,Oxford County,17539,14603,33205,2936,0.528203584,0.439783165,0.088420419
Maine,23019 ,Penobscot County,44477,37563,84948,6914,0.523579131,0.442188162,0.081390969
Maine,23021 ,Piscataquis County,6143,3517,9918,2626,0.619378907,0.354607784,0.264771123
Maine,23023 ,Sagadahoc County,9755,13528,24038,-3773,0.405815792,0.562775605,-0.156959814
Maine,23025 ,Somerset County,16471,10136,27367,6335,0.60185625,0.370373077,0.231483173
Maine,23027 ,Waldo County,11477,12632,24956,-1155,0.459889405,0.506170861,-0.046281455
Maine,23029 ,Washington County,10173,6752,17332,3421,0.586948996,0.389568428,0.197380568
Maine,23031 ,York County,54817,71189,129818,-16372,0.422260395,0.548375418,-0.126115023
Maryland,24001 ,Allegany County,20886,9158,30511,11728,0.684540002,0.300154043,0.384385959
Maryland,24003 ,Anne Arundel County,127821,172823,306924,-45002,0.416458146,0.563080763,-0.146622617
Maryland,24005 ,Baltimore County,146202,258409,411906,-112207,0.354940205,0.627349444,-0.272409239
Maryland,24009 ,Calvert County,25346,22587,48832,2759,0.519044889,0.462545052,0.056499836
Maryland,24011 ,Caroline County,10283,5095,15729,5188,0.65376057,0.323923962,0.329836608
Maryland,24013 ,Carroll County,60218,36456,99408,23762,0.605766136,0.366731048,0.239035088
Maryland,24015 ,Cecil County,29439,16809,47273,12630,0.622744484,0.355572949,0.267171536
Maryland,24017 ,Charles County,25579,62171,89063,-36592,0.287201195,0.698056432,-0.410855237
Maryland,24019 ,Dorchester County,8764,6857,15934,1907,0.550018828,0.430337643,0.119681185
Maryland,24021 ,Frederick County,63682,77675,144568,-13993,0.440498589,0.53729041,-0.096791821
Maryland,24023 ,Garrett County,12002,3281,15579,8721,0.770396046,0.210604018,0.559792028
Maryland,24025 ,Harford County,80930,63095,147221,17835,0.549717771,0.428573369,0.121144402
Maryland,24027 ,Howard County,48390,129433,181324,-81043,0.266870354,0.713821667,-0.446951314
Maryland,24029 ,Kent County,5195,5329,10740,-134,0.483705773,0.496182495,-0.012476723
Maryland,24031 ,Montgomery County,101222,419569,529569,-318347,0.191140342,0.792283914,-0.601143571
Maryland,24033 ,Prince George's County,37090,379208,422851,-342118,0.087714112,0.896788703,-0.809074591
Maryland,24035 ,Queen Anne's County,18741,10709,30079,8032,0.623059277,0.356029123,0.267030154
Maryland,24037 ,St. Mary's County,30826,23138,55339,7688,0.557039339,0.418113808,0.138925532
Maryland,24039 ,Somerset County,5739,4241,10117,1498,0.567263023,0.419195414,0.148067609
Maryland,24041 ,Talbot County,10946,11062,22400,-116,0.488660714,0.493839286,-0.005178571
Maryland,24043 ,Washington County,40224,26044,67510,14180,0.595822841,0.385779884,0.210042957
Maryland,24045 ,Wicomico County,22944,22054,45975,890,0.499053834,0.479695487,0.019358347
Maryland,24047 ,Worcester County,18571,12560,31567,6011,0.588304242,0.397883866,0.190420376
Maryland,24510 ,Baltimore city,25374,207260,236189,-181886,0.107430913,0.877517581,-0.770086668
Massachusetts,25001 ,Barnstable County,55311,91994,150335,-36683,0.367918316,0.611926697,-0.244008381
Massachusetts,25003 ,Berkshire County,18064,51705,71375,-33641,0.253085814,0.72441331,-0.471327496
Massachusetts,25005 ,Bristol County,119872,153377,279279,-33505,0.429219526,0.549189162,-0.119969636
Massachusetts,25007 ,Dukes County,2631,9914,12798,-7283,0.205578997,0.774652289,-0.569073293
Massachusetts,25009 ,Essex County,144837,267198,421210,-122361,0.343859358,0.634358159,-0.290498801
Massachusetts,25011 ,Franklin County,11201,30030,42459,-18829,0.263807438,0.707270543,-0.443463106
Massachusetts,25013 ,Hampden County,87318,125948,218177,-38630,0.400216338,0.577274415,-0.177058077
Massachusetts,25015 ,Hampshire County,22281,63362,87852,-41081,0.253619724,0.721235715,-0.467615991
Massachusetts,25017 ,Middlesex County,226956,617196,863628,-390240,0.262793703,0.714654921,-0.451861218
Massachusetts,25019 ,Nantucket County,1914,5241,7306,-3327,0.261976458,0.717355598,-0.45537914
Massachusetts,25021 ,Norfolk County,125294,273312,407756,-148018,0.307276901,0.670283209,-0.363006308
Massachusetts,25023 ,Plymouth County,121227,173630,301812,-52403,0.40166395,0.575291904,-0.173627954
Massachusetts,25025 ,Suffolk County,58613,270522,335462,-211909,0.174723218,0.806416226,-0.631693008
Massachusetts,25027 ,Worcester County,171683,248773,432024,-77090,0.397392275,0.575831435,-0.178439161
Michigan,26001 ,Alcona County,4848,2142,7063,2706,0.686393884,0.303270565,0.383123319
Michigan,26003 ,Alger County,3014,2053,5135,961,0.586952288,0.399805258,0.18714703
Michigan,26005 ,Allegan County,41392,24449,67195,16943,0.615998214,0.363851477,0.252146737
Michigan,26007 ,Alpena County,10686,6000,16966,4686,0.629847931,0.353648473,0.276199458
Michigan,26009 ,Antrim County,9748,5960,15969,3788,0.610432713,0.37322312,0.237209594
Michigan,26011 ,Arenac County,5928,2774,8831,3154,0.671271657,0.314120711,0.357150946
Michigan,26013 ,Baraga County,2512,1478,4036,1034,0.622398414,0.366204163,0.256194252
Michigan,26015 ,Barry County,23471,11797,35905,11674,0.653697257,0.328561482,0.325135775
Michigan,26017 ,Bay County,33125,26151,60253,6974,0.549765157,0.434019883,0.115745274
Michigan,26019 ,Benzie County,6601,5480,12260,1121,0.538417618,0.446982055,0.091435563
Michigan,26021 ,Berrien County,43519,37438,82379,6081,0.528277838,0.454460481,0.073817356
Michigan,26023 ,Branch County,14064,6159,20536,7905,0.684846124,0.299912349,0.384933775
Michigan,26025 ,Calhoun County,36221,28877,66276,7344,0.546517593,0.43570825,0.110809343
Michigan,26027 ,Cass County,16699,9130,26242,7569,0.636346315,0.347915555,0.28843076
Michigan,26029 ,Charlevoix County,9841,6939,17000,2902,0.578882353,0.408176471,0.170705882
Michigan,26031 ,Cheboygan County,10186,5437,15868,4749,0.641920847,0.342639274,0.299281573
Michigan,26033 ,Chippewa County,10681,6648,17671,4033,0.604436648,0.376209609,0.228227039
Michigan,26035 ,Clare County,10861,5199,16281,5662,0.667096616,0.31932928,0.347767336
Michigan,26037 ,Clinton County,25098,21968,47910,3130,0.523857232,0.458526404,0.065330829
Michigan,26039 ,Crawford County,5087,2672,7861,2415,0.647118687,0.339905864,0.307212823
Michigan,26041 ,Delta County,13207,7606,21156,5601,0.624267347,0.359519758,0.264747589
Michigan,26043 ,Dickinson County,9617,4744,14589,4873,0.659195284,0.325176503,0.334018781
Michigan,26045 ,Eaton County,31798,31299,64454,499,0.49334409,0.485602135,0.007741956
Michigan,26047 ,Emmet County,12135,9662,22176,2473,0.547213203,0.435696248,0.111516955
Michigan,26049 ,Genesee County,98714,119390,221781,-20676,0.44509674,0.538323842,-0.093227102
Michigan,26051 ,Gladwin County,9893,4524,14603,5369,0.677463535,0.309799356,0.367664179
Michigan,26053 ,Gogebic County,4600,3570,8276,1030,0.55582407,0.431367811,0.124456259
Michigan,26055 ,Grand Traverse County,30502,28683,60227,1819,0.506450595,0.476248194,0.030202401
Michigan,26057 ,Gratiot County,12102,6693,19148,5409,0.632024232,0.349540422,0.28248381
Michigan,26059 ,Hillsdale County,17037,5883,23288,11154,0.731578495,0.252619375,0.478959121
Michigan,26061 ,Houghton County,10378,7750,18533,2628,0.5599741,0.418172989,0.141801112
Michigan,26063 ,Huron County,12731,5490,18452,7241,0.689952309,0.297528723,0.392423586
Michigan,26065 ,Ingham County,47639,94212,144788,-46573,0.329025886,0.650689284,-0.321663398
Michigan,26067 ,Ionia County,20657,10901,32205,9756,0.641422139,0.338487812,0.302934327
Michigan,26069 ,Iosco County,9759,5373,15387,4386,0.634236693,0.349190875,0.285045818
Michigan,26071 ,Iron County,4216,2493,6795,1723,0.620456218,0.366887417,0.253568801
Michigan,26073 ,Isabella County,14815,14072,29409,743,0.503757353,0.478492978,0.025264375
Michigan,26075 ,Jackson County,47372,31995,81014,15377,0.58473844,0.39493174,0.1898067
Michigan,26077 ,Kalamazoo County,56823,83686,143376,-26863,0.39632156,0.583682067,-0.187360507
Michigan,26079 ,Kalkaska County,7436,3002,10630,4434,0.699529633,0.282408278,0.417121355
Michigan,26081 ,Kent County,165741,187915,360839,-22174,0.459321193,0.520772422,-0.061451229
Michigan,26083 ,Keweenaw County,862,672,1557,190,0.553628773,0.431599229,0.122029544
Michigan,26085 ,Lake County,3946,2288,6332,1658,0.623183828,0.361339229,0.261844599
Michigan,26087 ,Lapeer County,35482,16367,52640,19115,0.674050152,0.310923252,0.3631269
Michigan,26089 ,Leelanau County,7916,8795,16933,-879,0.467489518,0.519399988,-0.051910471
Michigan,26091 ,Lenawee County,31541,20918,53452,10623,0.59008082,0.391341765,0.198739056
Michigan,26093 ,Livingston County,76982,48220,127166,28762,0.605366214,0.379189406,0.226176808
Michigan,26095 ,Luce County,2109,842,3001,1267,0.702765745,0.280573142,0.422192602
Michigan,26097 ,Mackinac County,4304,2632,7015,1672,0.613542409,0.375196009,0.238346401
Michigan,26099 ,Macomb County,263863,223952,494219,39911,0.53389894,0.453143242,0.080755697
Michigan,26101 ,Manistee County,8321,6107,14654,2214,0.567831309,0.416746281,0.151085028
Michigan,26103 ,Marquette County,16286,20465,37458,-4179,0.434780287,0.54634524,-0.111564953
Michigan,26105 ,Mason County,10207,6802,17249,3405,0.591744449,0.394341701,0.197402748
Michigan,26107 ,Mecosta County,13267,7375,21081,5892,0.629334472,0.349841089,0.279493383
Michigan,26109 ,Menominee County,8117,4316,12621,3801,0.643134458,0.341969733,0.301164725
Michigan,26111 ,Midland County,27675,20493,49175,7182,0.562785968,0.416736146,0.146049822
Michigan,26113 ,Missaukee County,6648,1967,8755,4681,0.759337521,0.224671616,0.534665905
Michigan,26115 ,Monroe County,52710,32975,87148,19735,0.604833157,0.378379309,0.226453849
Michigan,26117 ,Montcalm County,21815,9703,32086,12112,0.679891541,0.302406034,0.377485508
Michigan,26119 ,Montmorency County,4171,1628,5863,2543,0.711410541,0.277673546,0.433736995
Michigan,26121 ,Muskegon County,45133,45643,92435,-510,0.488267431,0.493784822,-0.005517391
Michigan,26123 ,Newaygo County,18857,7873,27156,10984,0.694395345,0.289917514,0.404477832
Michigan,26125 ,Oakland County,325971,434148,771991,-108177,0.422247151,0.562374432,-0.140127281
Michigan,26127 ,Oceana County,8892,4944,14080,3948,0.631534091,0.351136364,0.280397727
Michigan,26129 ,Ogemaw County,8253,3475,11907,4778,0.693121693,0.291845133,0.40127656
Michigan,26131 ,Ontonagon County,2358,1391,3810,967,0.618897638,0.365091864,0.253805774
Michigan,26133 ,Osceola County,8928,3214,12340,5714,0.72350081,0.260453809,0.463047002
Michigan,26135 ,Oscoda County,3466,1342,4874,2124,0.71112023,0.275338531,0.435781699
Michigan,26137 ,Otsego County,9779,4743,14756,5036,0.662713472,0.321428571,0.341284901
Michigan,26139 ,Ottawa County,100913,64705,168627,36208,0.598439159,0.383716724,0.214722435
Michigan,26141 ,Presque Isle County,5342,2911,8355,2431,0.639377618,0.348414123,0.290963495
Michigan,26143 ,Roscommon County,9670,5166,15018,4504,0.643893994,0.343987215,0.299906779
Michigan,26145 ,Saginaw County,50785,51088,103347,-303,0.49140275,0.49433462,-0.00293187
Michigan,26147 ,St. Clair County,59185,31363,92063,27822,0.642874988,0.34066889,0.302206098
Michigan,26149 ,St. Joseph County,18127,9262,27981,8865,0.647832458,0.331010328,0.316822129
Michigan,26151 ,Sanilac County,16194,5966,22446,10228,0.721464849,0.26579346,0.455671389
Michigan,26153 ,Schoolcraft County,3090,1589,4745,1501,0.651211802,0.33487882,0.316332982
Michigan,26155 ,Shiawassee County,23149,15347,39220,7802,0.590234574,0.391305456,0.198929118
Michigan,26157 ,Tuscola County,20297,8712,29479,11585,0.688524034,0.295532413,0.392991621
Michigan,26159 ,Van Buren County,21591,16803,39063,4788,0.552722525,0.430151294,0.122571231
Michigan,26161 ,Washtenaw County,56241,157136,216931,-100895,0.259257552,0.724359359,-0.465101807
Michigan,26163 ,Wayne County,264553,597170,874018,-332617,0.302685986,0.683246798,-0.380560812
Michigan,26165 ,Wexford County,12102,5838,18292,6264,0.6616007,0.319155915,0.342444785
Minnesota,27001 ,Aitkin County,6258,3607,10025,2651,0.624239401,0.359800499,0.264438903
Minnesota,27003 ,Anoka County,104902,100893,211132,4009,0.496855048,0.477866927,0.018988121
Minnesota,27005 ,Becker County,12438,6589,19401,5849,0.641100974,0.339621669,0.301479305
Minnesota,27007 ,Beltrami County,12188,11426,24189,762,0.503865393,0.472363471,0.031501922
Minnesota,27009 ,Benton County,14382,7280,22260,7102,0.646091644,0.327044025,0.319047619
Minnesota,27011 ,Big Stone County,1863,1053,2974,810,0.626429052,0.354068594,0.272360457
Minnesota,27013 ,Blue Earth County,16731,18330,36051,-1599,0.464092536,0.508446368,-0.044353832
Minnesota,27015 ,Brown County,9552,4753,14635,4799,0.652681927,0.324769388,0.327912538
Minnesota,27017 ,Carlton County,9791,10098,20369,-307,0.480681428,0.495753351,-0.015071923
Minnesota,27019 ,Carver County,34009,30774,66361,3235,0.512484743,0.463736231,0.048748512
Minnesota,27021 ,Cass County,11620,6342,18289,5278,0.635354585,0.346765816,0.288588769
Minnesota,27023 ,Chippewa County,4250,2226,6611,2024,0.642867947,0.336711541,0.306156406
Minnesota,27025 ,Chisago County,21916,11806,34570,10110,0.633960081,0.34150998,0.292450101
Minnesota,27027 ,Clay County,15043,16357,32239,-1314,0.466608766,0.507366854,-0.040758088
Minnesota,27029 ,Clearwater County,3372,1260,4708,2112,0.716227698,0.267629567,0.448598131
Minnesota,27031 ,Cook County,1203,2496,3806,-1293,0.316079874,0.655806621,-0.339726747
Minnesota,27033 ,Cottonwood County,4165,1834,6107,2331,0.682004257,0.300311118,0.381693139
Minnesota,27035 ,Crow Wing County,25676,13726,40173,11950,0.639135738,0.341672267,0.29746347
Minnesota,27037 ,Dakota County,109638,146155,262259,-36517,0.418052383,0.5572926,-0.139240217
Minnesota,27039 ,Dodge County,7783,4079,12187,3704,0.638631328,0.334700911,0.303930418
Minnesota,27041 ,Douglas County,15799,7868,24165,7931,0.653796814,0.325594869,0.328201945
Minnesota,27043 ,Faribault County,5191,2531,7914,2660,0.655926207,0.31981299,0.336113217
Minnesota,27045 ,Fillmore County,7301,4551,12141,2750,0.601350795,0.374845565,0.22650523
Minnesota,27047 ,Freeborn County,9578,6889,16818,2689,0.56950886,0.409620645,0.159888215
Minnesota,27049 ,Goodhue County,16052,11806,28636,4246,0.56055315,0.412278251,0.148274899
Minnesota,27051 ,Grant County,2269,1300,3654,969,0.620963328,0.355774494,0.265188834
Minnesota,27053 ,Hennepin County,205973,532623,755969,-326650,0.272462231,0.704556668,-0.432094438
Minnesota,27055 ,Houston County,6334,4853,11440,1481,0.553671329,0.424213287,0.129458042
Minnesota,27057 ,Hubbard County,8202,4462,12965,3740,0.632626302,0.344157347,0.288468955
Minnesota,27059 ,Isanti County,16491,7138,24235,9353,0.680462142,0.294532701,0.385929441
Minnesota,27061 ,Itasca County,15239,10786,26561,4453,0.573735929,0.406084108,0.16765182
Minnesota,27063 ,Jackson County,3948,1745,5819,2203,0.678467091,0.299879704,0.378587386
Minnesota,27065 ,Kanabec County,6278,2774,9242,3504,0.679290197,0.300151482,0.379138715
Minnesota,27067 ,Kandiyohi County,14437,8440,23367,5997,0.617837121,0.361193136,0.256643985
Minnesota,27069 ,Kittson County,1546,1006,2639,540,0.585827965,0.381205002,0.204622963
Minnesota,27071 ,Koochiching County,4131,2659,6922,1472,0.596792834,0.384137533,0.212655302
Minnesota,27073 ,Lac qui Parle County,2528,1446,4040,1082,0.625742574,0.357920792,0.267821782
Minnesota,27075 ,Lake County,3393,3647,7202,-254,0.471119134,0.506387115,-0.035267981
Minnesota,27077 ,Lake of the Woods County,1704,671,2408,1033,0.707641196,0.278654485,0.428986711
Minnesota,27079 ,Le Sueur County,10775,5672,16818,5103,0.640682602,0.3372577,0.303424902
Minnesota,27081 ,Lincoln County,2121,937,3115,1184,0.680898876,0.300802568,0.380096308
Minnesota,27083 ,Lyon County,7979,4634,12893,3345,0.618862949,0.35941984,0.259443109
Minnesota,27085 ,McLeod County,13986,6413,20933,7573,0.668131658,0.306358382,0.361773277
Minnesota,27087 ,Mahnomen County,1142,1112,2304,30,0.495659722,0.482638889,0.013020833
Minnesota,27089 ,Marshall County,3721,1295,5113,2426,0.727752787,0.253275963,0.474476824
Minnesota,27091 ,Martin County,7480,3305,11009,4175,0.679444091,0.30020892,0.379235171
Minnesota,27093 ,Meeker County,9359,3867,13529,5492,0.691773228,0.285830438,0.40594279
Minnesota,27095 ,Mille Lacs County,9952,4404,14689,5548,0.677513786,0.299816189,0.377697597
Minnesota,27097 ,Morrison County,14821,4367,19558,10454,0.757797321,0.223284589,0.534512731
Minnesota,27099 ,Mower County,10025,8899,19345,1126,0.518221763,0.460015508,0.058206255
Minnesota,27101 ,Murray County,3363,1449,4896,1914,0.686887255,0.295955882,0.390931373
Minnesota,27103 ,Nicollet County,9018,9622,19125,-604,0.471529412,0.503111111,-0.031581699
Minnesota,27105 ,Nobles County,5600,2933,8715,2667,0.642570281,0.336546185,0.306024096
Minnesota,27107 ,Norman County,1953,1404,3441,549,0.567567568,0.408020924,0.159546643
Minnesota,27109 ,Olmsted County,39692,49491,91385,-9799,0.434338239,0.541565903,-0.107227663
Minnesota,27111 ,Otter Tail County,23800,11958,36399,11842,0.653864117,0.328525509,0.325338608
Minnesota,27113 ,Pennington County,4532,2568,7277,1964,0.622784114,0.352892676,0.269891439
Minnesota,27115 ,Pine County,10256,5419,16001,4837,0.64095994,0.338666333,0.302293607
Minnesota,27117 ,Pipestone County,3553,1306,4940,2247,0.719230769,0.26437247,0.4548583
Minnesota,27119 ,Polk County,9865,5439,15594,4426,0.632615108,0.348787995,0.283827113
Minnesota,27121 ,Pope County,4417,2477,7022,1940,0.62902307,0.352748505,0.276274566
Minnesota,27123 ,Ramsey County,77376,211620,295977,-134244,0.261425719,0.714987989,-0.45356227
Minnesota,27125 ,Red Lake County,1454,691,2196,763,0.662112933,0.314663024,0.347449909
Minnesota,27127 ,Redwood County,5771,2355,8284,3416,0.696644133,0.284282955,0.412361178
Minnesota,27129 ,Renville County,5467,2496,8128,2971,0.672613189,0.307086614,0.365526575
Minnesota,27131 ,Rice County,17464,17402,35686,62,0.489379589,0.487642213,0.001737376
Minnesota,27133 ,Rock County,3583,1556,5240,2027,0.683778626,0.296946565,0.386832061
Minnesota,27135 ,Roseau County,6065,2188,8421,3877,0.720223251,0.259826624,0.460396627
Minnesota,27137 ,St. Louis County,49017,67704,119531,-18687,0.41007772,0.566413734,-0.156336013
Minnesota,27139 ,Scott County,45872,40040,87965,5832,0.521480134,0.455181038,0.066299096
Minnesota,27141 ,Sherburne County,36222,18065,55612,18157,0.651334244,0.324839963,0.326494282
Minnesota,27143 ,Sibley County,5864,2417,8451,3447,0.693882381,0.286001657,0.407880724
Minnesota,27145 ,Stearns County,50959,31879,84835,19080,0.60068368,0.375776507,0.224907173
Minnesota,27147 ,Steele County,12656,7917,21128,4739,0.599015524,0.374716017,0.224299508
Minnesota,27149 ,Stevens County,3044,1922,5085,1122,0.598623402,0.377974435,0.220648968
Minnesota,27151 ,Swift County,3316,1784,5193,1532,0.638551897,0.34353938,0.295012517
Minnesota,27153 ,Todd County,9753,3286,13257,6467,0.735686807,0.24786905,0.487817757
Minnesota,27155 ,Traverse County,1172,661,1864,511,0.628755365,0.354613734,0.274141631
Minnesota,27157 ,Wabasha County,8153,4696,13123,3457,0.621275623,0.357845005,0.263430618
Minnesota,27159 ,Wadena County,5520,2023,7677,3497,0.719030871,0.263514394,0.455516478
Minnesota,27161 ,Waseca County,6624,3496,10389,3128,0.637597459,0.33650977,0.301087689
Minnesota,27163 ,Washington County,73764,89165,166786,-15401,0.442267337,0.534607221,-0.092339885
Minnesota,27165 ,Watonwan County,3103,1987,5201,1116,0.596616035,0.382041915,0.21457412
Minnesota,27167 ,Wilkin County,2328,1026,3430,1302,0.678717201,0.299125364,0.379591837
Minnesota,27169 ,Winona County,13227,13333,27173,-106,0.486769955,0.490670887,-0.003900931
Minnesota,27171 ,Wright County,51973,28430,82426,23543,0.630541334,0.344915439,0.285625895
Minnesota,27173 ,Yellow Medicine County,3734,1688,5528,2046,0.675470333,0.305354559,0.370115774
Mississippi,28001 ,Adams County,5696,7917,13759,-2221,0.413983574,0.575405189,-0.161421615
Mississippi,28003 ,Alcorn County,12818,2782,15811,10036,0.81070141,0.17595345,0.63474796
Mississippi,28005 ,Amite County,4503,2620,7207,1883,0.624809213,0.363535452,0.261273762
Mississippi,28007 ,Attala County,5178,3542,8832,1636,0.586277174,0.401041667,0.185235507
Mississippi,28009 ,Benton County,2570,1679,4292,891,0.598788444,0.391192917,0.207595527
Mississippi,28011 ,Bolivar County,4671,8904,13755,-4233,0.339585605,0.647328244,-0.307742639
Mississippi,28013 ,Calhoun County,4625,1902,6595,2723,0.701288855,0.288400303,0.412888552
Mississippi,28015 ,Carroll County,3924,1729,5705,2195,0.687817704,0.303067485,0.384750219
Mississippi,28017 ,Chickasaw County,4175,3810,8148,365,0.51239568,0.467599411,0.044796269
Mississippi,28019 ,Choctaw County,3001,1185,4225,1816,0.710295858,0.280473373,0.429822485
Mississippi,28021 ,Claiborne County,603,3772,4453,-3169,0.135414327,0.847069391,-0.711655064
Mississippi,28023 ,Clarke County,5417,2838,8347,2579,0.64897568,0.340002396,0.308973284
Mississippi,28025 ,Clay County,4181,5844,10206,-1663,0.409660984,0.57260435,-0.162943367
Mississippi,28027 ,Coahoma County,2400,6130,8642,-3730,0.277713492,0.709326545,-0.431613053
Mississippi,28029 ,Copiah County,6250,6470,12897,-220,0.484608824,0.501667054,-0.017058231
Mississippi,28031 ,Covington County,5854,3416,9371,2438,0.624693202,0.364528866,0.260164337
Mississippi,28033 ,DeSoto County,46462,28265,76248,18197,0.609353688,0.370698248,0.23865544
Mississippi,28035 ,Forrest County,17290,13755,31725,3535,0.54499606,0.43356974,0.11142632
Mississippi,28037 ,Franklin County,2923,1480,4464,1443,0.654793907,0.331541219,0.323252688
Mississippi,28039 ,George County,9713,1218,11064,8495,0.877892263,0.110086768,0.767805495
Mississippi,28041 ,Greene County,4794,966,5816,3828,0.824277854,0.166093535,0.658184319
Mississippi,28043 ,Grenada County,6081,4734,10919,1347,0.556919132,0.433556186,0.123362945
Mississippi,28045 ,Hancock County,16132,4504,20957,11628,0.769766665,0.214916257,0.554850408
Mississippi,28047 ,Harrison County,46822,27728,75865,19094,0.617175246,0.365491333,0.251683912
Mississippi,28049 ,Hinds County,25141,73550,100191,-48409,0.250930722,0.734097873,-0.483167151
Mississippi,28051 ,Holmes County,1369,6588,8115,-5219,0.168699938,0.811829945,-0.643130006
Mississippi,28053 ,Humphreys County,1118,3016,4189,-1898,0.266889472,0.719980902,-0.45309143
Mississippi,28055 ,Issaquena County,308,355,676,-47,0.455621302,0.525147929,-0.069526627
Mississippi,28057 ,Itawamba County,9438,1249,10826,8189,0.871790135,0.115370405,0.75641973
Mississippi,28059 ,Jackson County,36295,17375,54623,18920,0.664463687,0.318089449,0.346374238
Mississippi,28061 ,Jasper County,4302,4341,8742,-39,0.492107069,0.496568291,-0.004461222
Mississippi,28063 ,Jefferson County,531,3327,3911,-2796,0.135770903,0.850677576,-0.714906673
Mississippi,28065 ,Jefferson Davis County,2534,3599,6213,-1065,0.407854499,0.579269274,-0.171414775
Mississippi,28067 ,Jones County,21226,8517,30091,12709,0.705393639,0.283041441,0.422352198
Mississippi,28069 ,Kemper County,1787,2887,4732,-1100,0.377641589,0.610101437,-0.232459848
Mississippi,28071 ,Lafayette County,12949,10070,23481,2879,0.551467144,0.428857374,0.12260977
Mississippi,28073 ,Lamar County,20704,7340,28526,13364,0.725794012,0.257309122,0.468484891
Mississippi,28075 ,Lauderdale County,17967,12960,31266,5007,0.574649779,0.414507772,0.160142007
Mississippi,28077 ,Lawrence County,4285,2260,6617,2025,0.647574429,0.341544507,0.306029923
Mississippi,28079 ,Leake County,5228,3897,9204,1331,0.568013907,0.423402868,0.144611039
Mississippi,28081 ,Lee County,24207,12189,37003,12018,0.654190201,0.329405724,0.324784477
Mississippi,28083 ,Leflore County,3129,7648,10893,-4519,0.287248692,0.702102268,-0.414853576
Mississippi,28085 ,Lincoln County,11596,5040,16818,6556,0.689499346,0.299678915,0.38982043
Mississippi,28087 ,Lowndes County,13800,13087,27273,713,0.50599494,0.479851868,0.026143072
Mississippi,28089 ,Madison County,31091,24440,56335,6651,0.551894914,0.433833319,0.118061596
Mississippi,28091 ,Marion County,8273,3787,12194,4486,0.678448417,0.310562572,0.367885845
Mississippi,28093 ,Marshall County,7566,8057,15830,-491,0.477953253,0.50897031,-0.031017056
Mississippi,28095 ,Monroe County,11177,5874,17279,5303,0.646854563,0.339950229,0.306904335
Mississippi,28097 ,Montgomery County,2917,2121,5078,796,0.574438755,0.417684128,0.156754628
Mississippi,28099 ,Neshoba County,8320,3260,11720,5060,0.709897611,0.278156997,0.431740614
Mississippi,28101 ,Newton County,6997,3075,10189,3922,0.686720974,0.301796055,0.384924919
Mississippi,28103 ,Noxubee County,1240,4040,5341,-2800,0.232166261,0.756412657,-0.524246396
Mississippi,28105 ,Oktibbeha County,9004,10299,19812,-1295,0.454472037,0.519836463,-0.065364426
Mississippi,28107 ,Panola County,8060,7403,15635,657,0.515510074,0.473488967,0.042021106
Mississippi,28109 ,Pearl River County,19595,4148,24056,15447,0.814557699,0.172430994,0.642126704
Mississippi,28111 ,Perry County,4500,1362,5922,3138,0.759878419,0.229989868,0.529888551
Mississippi,28113 ,Pike County,8479,8646,17360,-167,0.488421659,0.498041475,-0.009619816
Mississippi,28115 ,Pontotoc County,11550,2614,14377,8936,0.803366488,0.181818182,0.621548306
Mississippi,28117 ,Prentiss County,8312,2139,10588,6173,0.785039668,0.202021156,0.583018512
Mississippi,28119 ,Quitman County,1026,2150,3229,-1124,0.317745432,0.665840818,-0.348095386
Mississippi,28121 ,Rankin County,50895,18847,70655,32048,0.720331187,0.266746869,0.453584318
Mississippi,28123 ,Scott County,6285,4330,10744,1955,0.584977662,0.403015637,0.181962025
Mississippi,28125 ,Sharkey County,688,1465,2183,-777,0.31516262,0.671094824,-0.355932203
Mississippi,28127 ,Simpson County,7635,4037,11820,3598,0.645939086,0.341539763,0.304399323
Mississippi,28129 ,Smith County,6458,1791,8327,4667,0.775549418,0.215083463,0.560465954
Mississippi,28131 ,Stone County,5964,1802,7878,4162,0.757044935,0.228738258,0.528306677
Mississippi,28133 ,Sunflower County,2799,6781,9683,-3982,0.289063307,0.700299494,-0.411236187
Mississippi,28135 ,Tallahatchie County,2488,3105,5691,-617,0.437181515,0.545598313,-0.108416798
Mississippi,28137 ,Tate County,8707,4183,13101,4524,0.664605755,0.319288604,0.345317151
Mississippi,28139 ,Tippah County,8054,1937,10102,6117,0.797267868,0.191744209,0.605523659
Mississippi,28141 ,Tishomingo County,7933,1059,9147,6874,0.867278889,0.115775664,0.751503225
Mississippi,28143 ,Tunica County,926,2580,3565,-1654,0.259747546,0.723702665,-0.463955119
Mississippi,28145 ,Union County,10373,2160,12683,8213,0.817866435,0.17030671,0.647559726
Mississippi,28147 ,Walthall County,4220,2835,7122,1385,0.592530188,0.398062342,0.194467846
Mississippi,28149 ,Warren County,10365,10442,21056,-77,0.492258739,0.495915653,-0.003656915
Mississippi,28151 ,Washington County,5300,12503,18025,-7203,0.294036061,0.693647712,-0.39961165
Mississippi,28153 ,Wayne County,6307,3624,10065,2683,0.626626925,0.360059613,0.266567312
Mississippi,28155 ,Webster County,4291,1043,5402,3248,0.794335431,0.193076638,0.601258793
Mississippi,28157 ,Wilkinson County,1324,2749,4130,-1425,0.320581114,0.665617433,-0.34503632
Mississippi,28159 ,Winston County,5112,4040,9244,1072,0.553007356,0.437040242,0.115967114
Mississippi,28161 ,Yalobusha County,3671,2785,6538,886,0.561486693,0.425971245,0.135515448
Mississippi,28163 ,Yazoo County,4832,5496,10441,-664,0.46279092,0.526386361,-0.063595441
Missouri,29001 ,Adair County,6391,3705,10337,2686,0.618264487,0.358421205,0.259843281
Missouri,29003 ,Andrew County,7256,2351,9775,4905,0.74230179,0.240511509,0.501790281
Missouri,29005 ,Atchison County,2199,564,2814,1635,0.781449893,0.200426439,0.581023454
Missouri,29007 ,Audrain County,7727,2703,10660,5024,0.724859287,0.253564728,0.471294559
Missouri,29009 ,Barry County,12425,2948,15598,9477,0.796576484,0.18899859,0.607577895
Missouri,29011 ,Barton County,5168,844,6077,4324,0.850419615,0.138884318,0.711535297
Missouri,29013 ,Bates County,6595,1672,8435,4923,0.781861292,0.198221695,0.583639597
Missouri,29015 ,Benton County,8106,2179,10478,5927,0.77362092,0.207959534,0.565661386
Missouri,29017 ,Bollinger County,5162,749,5981,4413,0.863066377,0.125229895,0.737836482
Missouri,29019 ,Boone County,38646,50064,91326,-11418,0.423165364,0.548190001,-0.125024637
Missouri,29021 ,Buchanan County,22450,13445,36713,9005,0.611500014,0.36621905,0.245280963
Missouri,29023 ,Butler County,14599,3301,18165,11298,0.803688412,0.181723094,0.621965318
Missouri,29025 ,Caldwell County,3725,897,4696,2828,0.793228279,0.191013629,0.602214651
Missouri,29027 ,Callaway County,14812,5868,21178,8944,0.699405043,0.277079989,0.422325054
Missouri,29029 ,Camden County,18825,5640,24774,13185,0.759869218,0.227658029,0.532211189
Missouri,29031 ,Cape Girardeau County,28873,10738,40252,18135,0.717305972,0.266769353,0.450536619
Missouri,29033 ,Carroll County,3706,785,4531,2921,0.817920989,0.173250938,0.644670051
Missouri,29035 ,Carter County,2451,418,2906,2033,0.843427392,0.14384033,0.699587061
Missouri,29037 ,Cass County,37172,19035,57524,18137,0.646199847,0.330905361,0.315294486
Missouri,29039 ,Cedar County,5786,1143,7039,4643,0.82199176,0.16238102,0.65961074
Missouri,29041 ,Chariton County,3109,916,4074,2193,0.763132057,0.224840452,0.538291605
Missouri,29043 ,Christian County,34904,11126,46904,23778,0.744158281,0.237207914,0.506950367
Missouri,29045 ,Clark County,2672,678,3394,1994,0.787271656,0.19976429,0.587507366
Missouri,29047 ,Clay County,64583,59519,126618,5064,0.510061761,0.470067447,0.039994314
Missouri,29049 ,Clinton County,7789,2894,10894,4895,0.714980723,0.265650817,0.449329906
Missouri,29051 ,Cole County,26066,12687,39486,13379,0.660132705,0.321303753,0.338828952
Missouri,29053 ,Cooper County,6272,2249,8710,4023,0.720091848,0.258208955,0.461882893
Missouri,29055 ,Crawford County,8725,2113,10973,6612,0.79513351,0.192563565,0.602569944
Missouri,29057 ,Dade County,3414,656,4123,2758,0.828037837,0.159107446,0.66893039
Missouri,29059 ,Dallas County,6620,1380,8122,5240,0.81507018,0.169908889,0.64516129
Missouri,29061 ,Daviess County,3077,740,3884,2337,0.792224511,0.190525232,0.601699279
Missouri,29063 ,DeKalb County,3827,930,4842,2897,0.790375878,0.192069393,0.598306485
Missouri,29065 ,Dent County,5987,1056,7142,4931,0.838280594,0.147857743,0.690422851
Missouri,29067 ,Douglas County,5896,1012,6994,4884,0.843008293,0.144695453,0.69831284
Missouri,29069 ,Dunklin County,8135,2200,10419,5935,0.780785104,0.211152702,0.569632402
Missouri,29071 ,Franklin County,38034,14561,53750,23473,0.707609302,0.270902326,0.436706977
Missouri,29073 ,Gasconade County,6222,1601,7934,4621,0.784219813,0.201789766,0.582430048
Missouri,29075 ,Gentry County,2580,613,3239,1967,0.796542143,0.189255943,0.607286199
Missouri,29077 ,Greene County,83630,55068,142272,28562,0.587817701,0.387061404,0.200756298
Missouri,29079 ,Grundy County,3585,799,4437,2786,0.807978364,0.180076628,0.627901735
Missouri,29081 ,Harrison County,3198,597,3825,2601,0.836078431,0.156078431,0.68
Missouri,29083 ,Henry County,8019,2615,10776,5404,0.744153675,0.242668894,0.501484781
Missouri,29085 ,Hickory County,3965,1054,5080,2911,0.780511811,0.207480315,0.573031496
Missouri,29087 ,Holt County,1976,338,2344,1638,0.843003413,0.144197952,0.698805461
Missouri,29089 ,Howard County,3552,1412,5089,2140,0.697976027,0.277461191,0.420514836
Missouri,29091 ,Howell County,15174,3214,18637,11960,0.814186833,0.172452648,0.641734185
Missouri,29093 ,Iron County,3596,945,4592,2651,0.783101045,0.205792683,0.577308362
Missouri,29095 ,Jackson County,126535,199842,334055,-73307,0.378784931,0.59823083,-0.2194459
Missouri,29097 ,Jasper County,37714,13539,52515,24175,0.718156717,0.257812054,0.460344663
Missouri,29099 ,Jefferson County,77021,37507,116629,39514,0.660393213,0.3215924,0.338800813
Missouri,29101 ,Johnson County,15468,6961,23134,8507,0.668626264,0.30089911,0.367727155
Missouri,29103 ,Knox County,1486,340,1856,1146,0.800646552,0.183189655,0.617456897
Missouri,29105 ,Laclede County,13755,2779,16819,10976,0.817825079,0.1652298,0.652595279
Missouri,29107 ,Lafayette County,12262,4470,17083,7792,0.717789615,0.261663642,0.456125973
Missouri,29109 ,Lawrence County,14421,3214,17930,11207,0.804294479,0.179252649,0.625041829
Missouri,29111 ,Lewis County,3541,984,4607,2557,0.76861298,0.213588018,0.555024962
Missouri,29113 ,Lincoln County,21702,6553,28814,15149,0.75317554,0.227424169,0.525751371
Missouri,29115 ,Linn County,4344,1274,5700,3070,0.762105263,0.223508772,0.538596491
Missouri,29117 ,Livingston County,5266,1409,6755,3857,0.779570688,0.208586232,0.570984456
Missouri,29119 ,McDonald County,7465,1437,9050,6028,0.824861878,0.15878453,0.666077348
Missouri,29121 ,Macon County,6075,1661,7834,4414,0.775465918,0.212024509,0.563441409
Missouri,29123 ,Madison County,4581,1017,5671,3564,0.80779404,0.179333451,0.628460589
Missouri,29125 ,Maries County,3890,814,4774,3076,0.814830331,0.170506912,0.644323419
Missouri,29127 ,Marion County,9910,3201,13370,6709,0.741211668,0.239416604,0.501795064
Missouri,29129 ,Mercer County,1541,222,1779,1319,0.866216976,0.124789207,0.741427768
Missouri,29131 ,Miller County,10175,2038,12379,8137,0.821956539,0.164633654,0.657322886
Missouri,29133 ,Mississippi County,3537,1178,4756,2359,0.743692178,0.247687132,0.496005046
Missouri,29135 ,Moniteau County,5738,1307,7150,4431,0.802517483,0.182797203,0.61972028
Missouri,29137 ,Monroe County,3466,931,4467,2535,0.775912245,0.208417282,0.567494963
Missouri,29139 ,Montgomery County,4457,1206,5770,3251,0.772443674,0.209012132,0.563431542
Missouri,29141 ,Morgan County,7439,1924,9484,5515,0.784373682,0.202867988,0.581505694
Missouri,29143 ,New Madrid County,5447,1748,7248,3699,0.75151766,0.241169978,0.510347682
Missouri,29145 ,Newton County,22090,5793,28396,16297,0.777926469,0.204007607,0.573918862
Missouri,29147 ,Nodaway County,6855,2849,9874,4006,0.694247519,0.288535548,0.405711971
Missouri,29149 ,Oregon County,3847,823,4742,3024,0.811261071,0.173555462,0.637705609
Missouri,29151 ,Osage County,6341,1031,7449,5310,0.851255202,0.13840784,0.712847362
Missouri,29153 ,Ozark County,4064,752,4870,3312,0.83449692,0.154414784,0.680082136
Missouri,29155 ,Pemiscot County,4116,1556,5727,2560,0.718700891,0.271695478,0.447005413
Missouri,29157 ,Perry County,7634,1661,9429,5973,0.809629865,0.176158659,0.633471206
Missouri,29159 ,Pettis County,13835,4776,19069,9059,0.7255231,0.25045886,0.47506424
Missouri,29161 ,Phelps County,13438,5619,19495,7819,0.68930495,0.288227751,0.401077199
Missouri,29163 ,Pike County,5856,1717,7686,4139,0.761904762,0.223393182,0.538511579
Missouri,29165 ,Platte County,29251,28111,58523,1140,0.499820583,0.480341062,0.019479521
Missouri,29167 ,Polk County,11849,2883,15059,8966,0.786838435,0.191446975,0.59539146
Missouri,29169 ,Pulaski County,10326,3735,14405,6591,0.716834432,0.25928497,0.457549462
Missouri,29171 ,Putnam County,1984,361,2361,1623,0.840321898,0.152901313,0.687420584
Missouri,29173 ,Ralls County,4396,1205,5662,3191,0.776404097,0.212822324,0.563581773
Missouri,29175 ,Randolph County,8018,2485,10742,5533,0.746415937,0.231334947,0.515080991
Missouri,29177 ,Ray County,8328,3107,11654,5221,0.714604428,0.266603741,0.448000686
Missouri,29179 ,Reynolds County,2733,529,3298,2204,0.828684051,0.160400243,0.668283808
Missouri,29181 ,Ripley County,4838,833,5743,4005,0.842416855,0.145046143,0.697370712
Missouri,29183 ,St. Charles County,128193,89346,222175,38847,0.576991111,0.402142455,0.174848655
Missouri,29185 ,St. Clair County,3930,988,4972,2942,0.790426388,0.198712792,0.591713596
Missouri,29186 ,Ste. Genevieve County,6627,2713,9495,3914,0.697946288,0.285729331,0.412216956
Missouri,29187 ,St. Francois County,20506,7044,27996,13462,0.73246178,0.251607372,0.480854408
Missouri,29189 ,St. Louis County,199493,328151,536446,-128658,0.371878996,0.611713015,-0.239834019
Missouri,29195 ,Saline County,6447,2903,9528,3544,0.67663728,0.30468094,0.371956339
Missouri,29197 ,Schuyler County,1606,373,2005,1233,0.800997506,0.186034913,0.614962594
Missouri,29199 ,Scotland County,1560,387,1985,1173,0.785894207,0.194962217,0.59093199
Missouri,29201 ,Scott County,13769,3753,17748,10016,0.775805725,0.211460446,0.564345278
Missouri,29203 ,Shannon County,3164,706,3908,2458,0.80962129,0.180655067,0.628966223
Missouri,29205 ,Shelby County,2699,592,3355,2107,0.804470939,0.176453055,0.628017884
Missouri,29207 ,Stoddard County,11460,1814,13410,9646,0.85458613,0.135272185,0.719313945
Missouri,29209 ,Stone County,14800,3506,18520,11294,0.799136069,0.189308855,0.609827214
Missouri,29211 ,Sullivan County,1974,478,2471,1496,0.798866856,0.19344395,0.605422906
Missouri,29213 ,Taney County,20426,5325,26240,15101,0.778429878,0.202934451,0.575495427
Missouri,29215 ,Texas County,9478,1716,11332,7762,0.836392517,0.15142958,0.684962937
Missouri,29217 ,Vernon County,7135,1902,9164,5233,0.778590135,0.207551288,0.571038848
Missouri,29219 ,Warren County,13222,4769,18373,8453,0.719642954,0.259565667,0.460077287
Missouri,29221 ,Washington County,8046,1804,9971,6242,0.806940126,0.180924682,0.626015445
Missouri,29223 ,Wayne County,4984,844,5874,4140,0.848484848,0.143684031,0.704800817
Missouri,29225 ,Webster County,14874,3572,18776,11302,0.792181508,0.190242863,0.601938645
Missouri,29227 ,Worth County,877,215,1107,662,0.792231256,0.194218609,0.598012647
Missouri,29229 ,Wright County,7452,1167,8737,6285,0.852924345,0.133569875,0.719354469
Missouri,29510 ,St. Louis city,21474,110089,134372,-88615,0.159810079,0.819285268,-0.659475188
Montana,30001 ,Beaverhead County,3923,1608,5661,2315,0.692987105,0.284048755,0.40893835
Montana,30003 ,Big Horn County,2207,2491,4784,-284,0.461329431,0.52069398,-0.059364548
Montana,30005 ,Blaine County,1469,1589,3117,-120,0.471286493,0.50978505,-0.038498556
Montana,30007 ,Broadwater County,3173,835,4097,2338,0.774469124,0.203807664,0.57066146
Montana,30009 ,Carbon County,4468,2421,7101,2047,0.629207154,0.340937896,0.288269258
Montana,30011 ,Carter County,775,74,864,701,0.896990741,0.085648148,0.811342593
Montana,30013 ,Cascade County,23315,15456,39885,7859,0.584555597,0.387514103,0.197041494
Montana,30015 ,Chouteau County,1891,991,2974,900,0.635843981,0.333221251,0.30262273
Montana,30017 ,Custer County,4205,1514,5883,2691,0.714771375,0.257351691,0.457419684
Montana,30019 ,Daniels County,799,195,1014,604,0.787968442,0.192307692,0.59566075
Montana,30021 ,Dawson County,3758,962,4837,2796,0.776927848,0.198883606,0.578044242
Montana,30023 ,Deer Lodge County,2186,2562,4891,-376,0.446943365,0.52381926,-0.076875895
Montana,30025 ,Fallon County,1375,172,1575,1203,0.873015873,0.109206349,0.763809524
Montana,30027 ,Fergus County,4869,1496,6531,3373,0.74552136,0.229061399,0.51645996
Montana,30029 ,Flathead County,38321,20274,60258,18047,0.635948754,0.336453251,0.299495503
Montana,30031 ,Gallatin County,31696,37044,71507,-5348,0.443257303,0.518047184,-0.074789881
Montana,30033 ,Garfield County,764,41,813,723,0.939729397,0.050430504,0.889298893
Montana,30035 ,Glacier County,1884,3610,5639,-1726,0.334101791,0.64018443,-0.306082639
Montana,30037 ,Golden Valley County,414,78,503,336,0.82306163,0.155069583,0.667992048
Montana,30039 ,Granite County,1419,638,2102,781,0.675071361,0.303520457,0.371550904
Montana,30041 ,Hill County,3957,2981,7182,976,0.550960735,0.415065441,0.135895294
Montana,30043 ,Jefferson County,5345,2625,8191,2720,0.652545477,0.320473691,0.332071786
Montana,30045 ,Judith Basin County,1040,275,1344,765,0.773809524,0.204613095,0.569196429
Montana,30047 ,Lake County,9322,6916,16626,2406,0.560688079,0.415974979,0.1447131
Montana,30049 ,Lewis and Clark County,21409,19743,42485,1666,0.50391903,0.46470519,0.03921384
Montana,30051 ,Liberty County,821,249,1083,572,0.758079409,0.229916898,0.528162512
Montana,30053 ,Lincoln County,8672,2835,11747,5837,0.738231038,0.241338214,0.496892824
Montana,30055 ,McCone County,956,155,1128,801,0.84751773,0.137411348,0.710106383
Montana,30057 ,Madison County,4191,1771,6113,2420,0.685588091,0.289710453,0.395877638
Montana,30059 ,Meagher County,833,258,1110,575,0.75045045,0.232432432,0.518018018
Montana,30061 ,Mineral County,1828,686,2563,1142,0.713226687,0.267655092,0.445571596
Montana,30063 ,Missoula County,26347,43357,71986,-17010,0.366001723,0.602297669,-0.236295946
Montana,30065 ,Musselshell County,2423,413,2881,2010,0.841027421,0.143353002,0.697674419
Montana,30067 ,Park County,6025,5280,11618,745,0.51859184,0.454467206,0.064124634
Montana,30069 ,Petroleum County,298,39,351,259,0.849002849,0.111111111,0.737891738
Montana,30071 ,Phillips County,1936,416,2386,1520,0.811399832,0.174350377,0.637049455
Montana,30073 ,Pondera County,2031,903,2995,1128,0.678130217,0.301502504,0.376627713
Montana,30075 ,Powder River County,970,154,1136,816,0.853873239,0.13556338,0.718309859
Montana,30077 ,Powell County,2355,752,3195,1603,0.737089202,0.235367762,0.50172144
Montana,30079 ,Prairie County,603,126,744,477,0.810483871,0.169354839,0.641129032
Montana,30081 ,Ravalli County,19114,8763,28507,10351,0.670501982,0.307398183,0.363103799
Montana,30083 ,Richland County,4800,875,5798,3925,0.82787168,0.150914108,0.676957572
Montana,30085 ,Roosevelt County,1996,1910,4028,86,0.495531281,0.474180735,0.021350546
Montana,30087 ,Rosebud County,2486,1199,3784,1287,0.656976744,0.316860465,0.340116279
Montana,30089 ,Sanders County,5660,1820,7652,3840,0.739675902,0.237846315,0.501829587
Montana,30091 ,Sheridan County,1403,574,2030,829,0.691133005,0.282758621,0.408374384
Montana,30093 ,Silver Bow County,7745,10392,18827,-2647,0.411377277,0.55197323,-0.140595953
Montana,30095 ,Stillwater County,4462,1156,5741,3306,0.777216513,0.201358648,0.575857864
Montana,30097 ,Sweet Grass County,1840,549,2446,1291,0.752248569,0.224448078,0.527800491
Montana,30099 ,Teton County,2608,1007,3695,1601,0.705818674,0.272530447,0.433288227
Montana,30101 ,Toole County,1596,467,2123,1129,0.751766368,0.219971738,0.53179463
Montana,30103 ,Treasure County,373,78,460,295,0.810869565,0.169565217,0.641304348
Montana,30105 ,Valley County,3135,1030,4272,2105,0.733848315,0.241104869,0.492743446
Montana,30107 ,Wheatland County,823,225,1068,598,0.770599251,0.210674157,0.559925094
Montana,30109 ,Wibaux County,516,77,598,439,0.862876254,0.128762542,0.734113712
Montana,30111 ,Yellowstone County,50772,30679,83821,20093,0.60571933,0.366006132,0.239713198
Nebraska,31001 ,Adams County,10085,4213,14602,5872,0.690658814,0.28852212,0.402136694
Nebraska,31003 ,Antelope County,3093,452,3583,2641,0.863243092,0.12615127,0.737091822
Nebraska,31005 ,Arthur County,260,21,284,239,0.915492958,0.073943662,0.841549296
Nebraska,31007 ,Banner County,362,43,410,319,0.882926829,0.104878049,0.77804878
Nebraska,31009 ,Blaine County,280,35,317,245,0.883280757,0.110410095,0.772870662
Nebraska,31011 ,Boone County,2653,499,3217,2154,0.82468138,0.15511346,0.66956792
Nebraska,31013 ,Box Butte County,4002,1051,5181,2951,0.772437753,0.202856591,0.569581162
Nebraska,31015 ,Boyd County,1010,135,1153,875,0.875975716,0.117085863,0.758889853
Nebraska,31017 ,Brown County,1470,191,1679,1279,0.875521144,0.113758189,0.761762954
Nebraska,31019 ,Buffalo County,16640,6350,23589,10290,0.70541354,0.269193268,0.436220272
Nebraska,31021 ,Burt County,2580,1063,3731,1517,0.691503618,0.284910212,0.406593407
Nebraska,31023 ,Butler County,3542,873,4498,2669,0.787461094,0.194086261,0.593374833
Nebraska,31025 ,Cass County,10121,4737,15284,5384,0.66219576,0.309931955,0.352263805
Nebraska,31027 ,Cedar County,4174,725,4996,3449,0.835468375,0.145116093,0.690352282
Nebraska,31029 ,Chase County,1740,226,1993,1514,0.873055695,0.113396889,0.759658806
Nebraska,31031 ,Cherry County,2844,373,3265,2471,0.871056662,0.11424196,0.756814701
Nebraska,31033 ,Cheyenne County,3813,855,4765,2958,0.800209864,0.179433368,0.620776495
Nebraska,31035 ,Clay County,2848,632,3558,2216,0.800449691,0.177627881,0.62282181
Nebraska,31037 ,Colfax County,2636,1025,3726,1611,0.707461084,0.275093935,0.43236715
Nebraska,31039 ,Cuming County,3507,870,4451,2637,0.787912829,0.195461694,0.592451135
Nebraska,31041 ,Custer County,5090,786,5993,4304,0.849324212,0.131153012,0.7181712
Nebraska,31043 ,Dakota County,3926,2744,6794,1182,0.57786282,0.403885782,0.173977039
Nebraska,31045 ,Dawes County,2931,1082,4121,1849,0.711235137,0.262557632,0.448677505
Nebraska,31047 ,Dawson County,6524,2497,9178,4027,0.710830246,0.27206363,0.438766616
Nebraska,31049 ,Deuel County,871,141,1032,730,0.843992248,0.136627907,0.707364341
Nebraska,31051 ,Dixon County,2335,651,3083,1684,0.757379176,0.211157963,0.546221213
Nebraska,31053 ,Dodge County,10984,5544,16876,5440,0.650865134,0.328513866,0.322351268
Nebraska,31055 ,Douglas County,119159,150350,274951,-31191,0.433382675,0.546824707,-0.113442031
Nebraska,31057 ,Dundy County,883,105,999,778,0.883883884,0.105105105,0.778778779
Nebraska,31059 ,Fillmore County,2359,693,3134,1666,0.752712189,0.221123165,0.531589024
Nebraska,31061 ,Franklin County,1437,276,1724,1161,0.833526682,0.160092807,0.673433875
Nebraska,31063 ,Frontier County,1229,189,1440,1040,0.853472222,0.13125,0.722222222
Nebraska,31065 ,Furnas County,2163,399,2601,1764,0.83160323,0.153402537,0.678200692
Nebraska,31067 ,Gage County,7445,3385,11068,4060,0.67265992,0.305836646,0.366823274
Nebraska,31069 ,Garden County,1016,161,1195,855,0.850209205,0.134728033,0.715481172
Nebraska,31071 ,Garfield County,933,133,1075,800,0.867906977,0.12372093,0.744186047
Nebraska,31073 ,Gosper County,893,215,1118,678,0.798747764,0.192307692,0.606440072
Nebraska,31075 ,Grant County,375,20,402,355,0.932835821,0.049751244,0.883084577
Nebraska,31077 ,Greeley County,1016,229,1258,787,0.807631161,0.182034976,0.625596184
Nebraska,31079 ,Hall County,16189,7681,24374,8508,0.664191351,0.315130877,0.349060474
Nebraska,31081 ,Hamilton County,4309,1118,5533,3191,0.778781854,0.202060365,0.576721489
Nebraska,31083 ,Harlan County,1615,282,1928,1333,0.837655602,0.14626556,0.691390041
Nebraska,31085 ,Hayes County,494,34,534,460,0.925093633,0.063670412,0.861423221
Nebraska,31087 ,Hitchcock County,1264,175,1469,1089,0.860449285,0.119128659,0.741320626
Nebraska,31089 ,Holt County,4769,686,5537,4083,0.861296731,0.123893805,0.737402926
Nebraska,31091 ,Hooker County,376,59,442,317,0.850678733,0.133484163,0.71719457
Nebraska,31093 ,Howard County,2786,648,3501,2138,0.795772636,0.185089974,0.610682662
Nebraska,31095 ,Jefferson County,2616,1016,3716,1600,0.703982777,0.273412271,0.430570506
Nebraska,31097 ,Johnson County,1518,647,2229,871,0.68102288,0.290264693,0.390758188
Nebraska,31099 ,Kearney County,2822,701,3604,2121,0.783018868,0.194506104,0.588512764
Nebraska,31101 ,Keith County,3544,763,4364,2781,0.812098992,0.174839597,0.637259395
Nebraska,31103 ,Keya Paha County,476,49,529,427,0.899810964,0.092627599,0.807183365
Nebraska,31105 ,Kimball County,1563,268,1874,1295,0.834044824,0.143009605,0.691035219
Nebraska,31107 ,Knox County,3721,905,4697,2816,0.792207792,0.192676176,0.599531616
Nebraska,31109 ,Lancaster County,70092,82293,156091,-12201,0.449045749,0.527211691,-0.078165942
Nebraska,31111 ,Lincoln County,13071,3692,17107,9379,0.764073186,0.215818086,0.5482551
Nebraska,31113 ,Logan County,407,38,450,369,0.904444444,0.084444444,0.82
Nebraska,31115 ,Loup County,370,75,454,295,0.814977974,0.165198238,0.649779736
Nebraska,31117 ,McPherson County,275,17,302,258,0.910596026,0.056291391,0.854304636
Nebraska,31119 ,Madison County,11940,3478,15765,8462,0.75737393,0.220615287,0.536758643
Nebraska,31121 ,Merrick County,3419,743,4282,2676,0.798458664,0.173517048,0.624941616
Nebraska,31123 ,Morrill County,2113,386,2558,1727,0.826035966,0.15089914,0.675136826
Nebraska,31125 ,Nance County,1437,359,1828,1078,0.786105033,0.196389497,0.589715536
Nebraska,31127 ,Nemaha County,2428,921,3423,1507,0.709319311,0.269062226,0.440257084
Nebraska,31129 ,Nuckolls County,1857,409,2303,1448,0.806339557,0.177594442,0.628745115
Nebraska,31131 ,Otoe County,5649,2490,8315,3159,0.679374624,0.299458809,0.379915815
Nebraska,31133 ,Pawnee County,1071,322,1429,749,0.749475157,0.2253324,0.524142757
Nebraska,31135 ,Perkins County,1321,199,1544,1122,0.855569948,0.12888601,0.726683938
Nebraska,31137 ,Phelps County,4157,752,5009,3405,0.829906169,0.150129766,0.679776402
Nebraska,31139 ,Pierce County,3462,480,4006,2982,0.864203694,0.11982027,0.744383425
Nebraska,31141 ,Platte County,12186,3260,15673,8926,0.777515472,0.208001021,0.569514452
Nebraska,31143 ,Polk County,2291,530,2879,1761,0.795762418,0.184091699,0.611670719
Nebraska,31145 ,Red Willow County,4525,811,5452,3714,0.829970653,0.148752751,0.681217902
Nebraska,31147 ,Richardson County,3073,996,4126,2077,0.744789142,0.241396025,0.503393117
Nebraska,31149 ,Rock County,744,84,841,660,0.884661118,0.099881094,0.784780024
Nebraska,31151 ,Saline County,3631,1986,5770,1645,0.629289428,0.344194107,0.285095321
Nebraska,31153 ,Sarpy County,51979,41206,96193,10773,0.540361565,0.428367969,0.111993596
Nebraska,31155 ,Saunders County,9108,3331,12735,5777,0.715194346,0.261562623,0.453631724
Nebraska,31157 ,Scotts Bluff County,10952,4196,15469,6756,0.707996638,0.271252182,0.436744457
Nebraska,31159 ,Seward County,6490,2438,9142,4052,0.709910304,0.266681251,0.443229053
Nebraska,31161 ,Sheridan County,2292,340,2672,1952,0.857784431,0.127245509,0.730538922
Nebraska,31163 ,Sherman County,1322,343,1698,979,0.778563015,0.202002356,0.57656066
Nebraska,31165 ,Sioux County,642,72,729,570,0.880658436,0.098765432,0.781893004
Nebraska,31167 ,Stanton County,2561,532,3165,2029,0.809162717,0.168088468,0.64107425
Nebraska,31169 ,Thayer County,2308,624,2980,1684,0.774496644,0.209395973,0.565100671
Nebraska,31171 ,Thomas County,377,45,427,332,0.882903981,0.105386417,0.777517564
Nebraska,31173 ,Thurston County,1180,1122,2325,58,0.507526882,0.482580645,0.024946237
Nebraska,31175 ,Valley County,1901,412,2340,1489,0.812393162,0.176068376,0.636324786
Nebraska,31177 ,Washington County,8583,3554,12413,5029,0.691452509,0.286312737,0.405139773
Nebraska,31179 ,Wayne County,3055,1022,4200,2033,0.727380952,0.243333333,0.484047619
Nebraska,31181 ,Webster County,1511,335,1876,1176,0.8054371,0.178571429,0.626865672
Nebraska,31183 ,Wheeler County,438,59,502,379,0.87250996,0.11752988,0.75498008
Nebraska,31185 ,York County,5337,1630,7143,3707,0.747165057,0.228195436,0.518969621
Nevada,32001 ,Churchill County,9372,3051,12890,6321,0.727075252,0.236695112,0.49038014
Nevada,32003 ,Clark County,430930,521852,972510,-90922,0.443111125,0.536603223,-0.093492098
Nevada,32005 ,Douglas County,21630,11571,34125,10059,0.633846154,0.339076923,0.294769231
Nevada,32007 ,Elko County,16741,4557,21967,12184,0.762097692,0.207447535,0.554650157
Nevada,32009 ,Esmeralda County,400,74,487,326,0.821355236,0.151950719,0.669404517
Nevada,32011 ,Eureka County,895,105,1017,790,0.880039331,0.103244838,0.776794494
Nevada,32013 ,Humboldt County,5877,1689,7771,4188,0.756273324,0.217346545,0.538926779
Nevada,32015 ,Lander County,2198,496,2765,1702,0.794936709,0.179385172,0.615551537
Nevada,32017 ,Lincoln County,2067,330,2446,1737,0.845053148,0.134914146,0.710139002
Nevada,32019 ,Lyon County,20914,8473,30238,12441,0.691646273,0.280210331,0.411435942
Nevada,32021 ,Mineral County,1423,829,2335,594,0.609421842,0.35503212,0.254389722
Nevada,32023 ,Nye County,17528,7288,25378,10240,0.690676964,0.287177871,0.403499094
Nevada,32027 ,Pershing County,1731,547,2320,1184,0.74612069,0.235775862,0.510344828
Nevada,32029 ,Storey County,1908,902,2877,1006,0.663190824,0.313521029,0.349669795
Nevada,32031 ,Washoe County,116760,128128,252142,-11368,0.463072396,0.508158101,-0.045085706
Nevada,32033 ,White Pine County,3403,859,4369,2544,0.778896773,0.196612497,0.582284276
Nevada,32510 ,Carson City,16113,12735,29739,3378,0.54181378,0.428225562,0.113588217
New Hampshire,33001 ,Belknap County,20899,16894,38453,4005,0.543494656,0.439341534,0.104153122
New Hampshire,33003 ,Carroll County,16150,16649,33272,-499,0.485393123,0.500390719,-0.014997596
New Hampshire,33005 ,Cheshire County,17892,25506,44206,-7614,0.404741438,0.5769805,-0.172239063
New Hampshire,33007 ,Coos County,8617,7640,16528,977,0.521357696,0.462245886,0.05911181
New Hampshire,33009 ,Grafton County,19905,33180,53989,-13275,0.368686214,0.614569635,-0.245883421
New Hampshire,33011 ,Hillsborough County,104625,122344,231040,-17719,0.452843663,0.529536011,-0.076692348
New Hampshire,33013 ,Merrimack County,39711,48533,89887,-8822,0.441788023,0.539933472,-0.098145449
New Hampshire,33015 ,Rockingham County,95858,100064,198943,-4206,0.481836506,0.50297824,-0.021141734
New Hampshire,33017 ,Strafford County,30489,41721,73729,-11232,0.41352792,0.565869604,-0.152341684
New Hampshire,33019 ,Sullivan County,11508,12390,24383,-882,0.471968175,0.508140918,-0.036172743
New Jersey,34001 ,Atlantic County,64326,73624,140141,-9298,0.459009141,0.525356605,-0.066347464
New Jersey,34003 ,Bergen County,204277,285811,497160,-81534,0.410887843,0.57488736,-0.163999517
New Jersey,34005 ,Burlington County,103326,154577,265967,-51251,0.388491805,0.581188644,-0.192696838
New Jersey,34007 ,Camden County,86024,174575,264912,-88551,0.324726702,0.65899242,-0.334265718
New Jersey,34009 ,Cape May County,33158,23941,57933,9217,0.572350819,0.413253241,0.159097578
New Jersey,34011 ,Cumberland County,28952,32742,62575,-3790,0.462676788,0.523244107,-0.060567319
New Jersey,34013 ,Essex County,75475,266820,345311,-191345,0.218571085,0.772694759,-0.554123674
New Jersey,34015 ,Gloucester County,83340,86702,173453,-3362,0.480475979,0.499858751,-0.019382772
New Jersey,34017 ,Hudson County,65698,181452,250458,-115754,0.262311445,0.724480751,-0.462169306
New Jersey,34019 ,Hunterdon County,43153,39457,84673,3696,0.509642979,0.465992701,0.043650278
New Jersey,34021 ,Mercer County,51461,122532,177069,-71071,0.290626818,0.692001423,-0.401374605
New Jersey,34023 ,Middlesex County,143461,226245,375681,-82784,0.381869192,0.602226357,-0.220357165
New Jersey,34025 ,Monmouth County,191808,181291,378390,10517,0.506905574,0.479111499,0.027794075
New Jersey,34027 ,Morris County,141134,153881,300917,-12747,0.46901305,0.511373568,-0.042360518
New Jersey,34029 ,Ocean County,217740,119456,342746,98284,0.635280937,0.348526314,0.286754623
New Jersey,34031 ,Passaic County,92009,129097,224330,-37088,0.410150225,0.57547809,-0.165327865
New Jersey,34033 ,Salem County,18781,14452,33969,4329,0.552886455,0.425446731,0.127439724
New Jersey,34035 ,Somerset County,71994,111113,186826,-39119,0.385353216,0.594740561,-0.209387344
New Jersey,34037 ,Sussex County,51566,34417,88148,17149,0.58499342,0.390445614,0.194547806
New Jersey,34039 ,Union County,80002,170245,254041,-90243,0.314917671,0.670147732,-0.355230061
New Jersey,34041 ,Warren County,34769,24901,61057,9868,0.569451496,0.407832026,0.16161947
New Mexico,35001 ,Bernalillo County,116135,193757,317590,-77622,0.365675871,0.61008533,-0.244409459
New Mexico,35003 ,Catron County,1698,595,2326,1103,0.730008598,0.255803955,0.474204643
New Mexico,35005 ,Chaves County,15656,6381,22443,9275,0.697589449,0.284320278,0.413269171
New Mexico,35006 ,Cibola County,3975,4745,8903,-770,0.446478715,0.532966416,-0.086487701
New Mexico,35007 ,Colfax County,3271,2611,6016,660,0.543716755,0.434009309,0.109707447
New Mexico,35009 ,Curry County,10444,4307,15101,6137,0.691609827,0.2852129,0.406396927
New Mexico,35011 ,De Baca County,656,231,901,425,0.728079911,0.256381798,0.471698113
New Mexico,35013 ,DoÃ±a Ana County,32802,47957,82641,-15155,0.396921625,0.580305175,-0.183383551
New Mexico,35015 ,Eddy County,17454,5424,23222,12030,0.751614848,0.233571613,0.518043235
New Mexico,35017 ,Grant County,6553,7590,14435,-1037,0.453966055,0.525805334,-0.07183928
New Mexico,35019 ,Guadalupe County,917,1234,2189,-317,0.418912746,0.56372773,-0.144814984
New Mexico,35021 ,Harding County,319,179,505,140,0.631683168,0.354455446,0.277227723
New Mexico,35023 ,Hidalgo County,1120,823,1974,297,0.567375887,0.416919959,0.150455927
New Mexico,35025 ,Lea County,16531,4061,20918,12470,0.790276317,0.194139019,0.596137298
New Mexico,35027 ,Lincoln County,6942,3194,10306,3748,0.673588201,0.309916553,0.363671648
New Mexico,35028 ,Los Alamos County,4278,7554,12293,-3276,0.348002928,0.614496055,-0.266493126
New Mexico,35029 ,Luna County,4408,3563,8103,845,0.543996051,0.439713686,0.104282365
New Mexico,35031 ,McKinley County,7801,18029,26486,-10228,0.294532961,0.680699237,-0.386166277
New Mexico,35033 ,Mora County,903,1745,2686,-842,0.33618764,0.649664929,-0.31347729
New Mexico,35035 ,Otero County,14521,8485,23571,6036,0.616053625,0.359976242,0.256077383
New Mexico,35037 ,Quay County,2634,1170,3873,1464,0.680092951,0.302091402,0.378001549
New Mexico,35039 ,Rio Arriba County,5408,10990,16628,-5582,0.325234544,0.660933365,-0.335698821
New Mexico,35041 ,Roosevelt County,4634,1802,6608,2832,0.701271186,0.272699758,0.428571429
New Mexico,35043 ,Sandoval County,34174,40588,76562,-6414,0.446357201,0.530132442,-0.083775241
New Mexico,35045 ,San Juan County,32874,18083,52294,14791,0.628638085,0.345794929,0.282843156
New Mexico,35047 ,San Miguel County,3421,7888,11531,-4467,0.296678519,0.684069031,-0.387390513
New Mexico,35049 ,Santa Fe County,18329,62530,82227,-44201,0.222907318,0.760455811,-0.537548494
New Mexico,35051 ,Sierra County,3542,2265,5945,1277,0.595794786,0.380992431,0.214802355
New Mexico,35053 ,Socorro County,3255,3722,7160,-467,0.454608939,0.519832402,-0.065223464
New Mexico,35055 ,Taos County,3715,13121,17181,-9406,0.216227228,0.763692451,-0.547465223
New Mexico,35057 ,Torrance County,4772,2344,7281,2428,0.655404477,0.3219338,0.333470677
New Mexico,35059 ,Union County,1388,383,1789,1005,0.775852432,0.214086082,0.56176635
New Mexico,35061 ,Valencia County,17364,14263,32277,3101,0.537968213,0.441893608,0.096074604
New York,36001 ,Albany County,45570,73189,121529,-27619,0.374972229,0.602234858,-0.227262629
New York,36003 ,Allegany County,14135,6048,20782,8087,0.680155904,0.291021076,0.389134828
New York,36005 ,Bronx County,55849,271835,329638,-215986,0.169425248,0.824647037,-0.655221789
New York,36007 ,Broome County,43728,46909,92853,-3181,0.470937934,0.505196386,-0.034258452
New York,36009 ,Cattaraugus County,22155,11879,34845,10276,0.635815755,0.340909743,0.294906012
New York,36011 ,Cayuga County,19495,16143,36433,3352,0.535091812,0.443087311,0.092004501
New York,36013 ,Chautauqua County,34853,23087,59304,11766,0.587700661,0.389299204,0.198401457
New York,36015 ,Chemung County,21922,16636,39410,5286,0.556254758,0.422126364,0.134128394
New York,36017 ,Chenango County,13464,8251,22269,5213,0.604607302,0.370515066,0.234092236
New York,36019 ,Clinton County,14354,12690,27471,1664,0.522514652,0.461941684,0.060572968
New York,36021 ,Columbia County,14453,20253,35363,-5800,0.408704013,0.572717247,-0.164013234
New York,36023 ,Cortland County,10788,10367,21675,421,0.497716263,0.478292964,0.019423299
New York,36025 ,Delaware County,11952,6420,18763,5532,0.636998348,0.342162767,0.294835581
New York,36027 ,Dutchess County,59661,57720,119539,1941,0.499092346,0.482854968,0.016237379
New York,36029 ,Erie County,178349,198808,383952,-20459,0.464508584,0.517793891,-0.053285306
New York,36031 ,Essex County,8976,9947,19259,-971,0.466067812,0.516485799,-0.050417986
New York,36033 ,Franklin County,8530,6586,15397,1944,0.554004027,0.427745665,0.126258362
New York,36035 ,Fulton County,13989,5804,20180,8185,0.6932111,0.287611497,0.405599604
New York,36037 ,Genesee County,18876,9625,29204,9251,0.646349815,0.32957814,0.316771675
New York,36039 ,Greene County,12722,7675,20882,5047,0.609232832,0.367541423,0.241691409
New York,36041 ,Hamilton County,2225,1178,3460,1047,0.643063584,0.340462428,0.302601156
New York,36043 ,Herkimer County,17038,7282,24766,9756,0.687959299,0.294032141,0.393927158
New York,36045 ,Jefferson County,25629,17307,43848,8322,0.584496442,0.394704433,0.189792009
New York,36047 ,Kings County,174731,514133,693937,-339402,0.251796633,0.740892905,-0.489096272
New York,36049 ,Lewis County,8890,3823,12964,5067,0.68574514,0.294893551,0.390851589
New York,36051 ,Livingston County,18182,12477,31401,5705,0.579026146,0.397344034,0.181682112
New York,36053 ,Madison County,18402,14785,34087,3617,0.539853903,0.433743069,0.106110834
New York,36055 ,Monroe County,145290,223936,378761,-78646,0.38359282,0.591232994,-0.207640174
New York,36057 ,Montgomery County,11500,5746,17615,5754,0.652852682,0.326199262,0.32665342
New York,36059 ,Nassau County,324858,392034,726335,-67176,0.447256431,0.539742681,-0.092486249
New York,36061 ,New York County,65001,377605,446861,-312604,0.14546134,0.845016683,-0.699555343
New York,36063 ,Niagara County,51355,34809,87821,16546,0.584769019,0.396363057,0.188405962
New York,36065 ,Oneida County,51950,30542,84273,21408,0.616448922,0.362417382,0.25403154
New York,36067 ,Onondaga County,84743,116031,206105,-31288,0.411164212,0.562970331,-0.151806118
New York,36069 ,Ontario County,25757,20779,47830,4978,0.538511395,0.434434455,0.104076939
New York,36071 ,Orange County,76218,61868,139956,14350,0.544585441,0.442053217,0.102532224
New York,36073 ,Orleans County,12126,5587,18154,6539,0.667951967,0.307755866,0.3601961
New York,36075 ,Oswego County,31677,20824,53787,10853,0.588934129,0.387156748,0.201777381
New York,36077 ,Otsego County,14366,12986,28075,1380,0.511700801,0.46254675,0.049154052
New York,36079 ,Putnam County,29277,24949,55110,4328,0.531246598,0.452712756,0.078533841
New York,36081 ,Queens County,181225,412393,597928,-231168,0.303088332,0.689703443,-0.386615111
New York,36083 ,Rensselaer County,36500,40969,79409,-4469,0.459645632,0.515923888,-0.056278256
New York,36085 ,Richmond County,110094,67223,178751,42871,0.615907044,0.376070623,0.23983642
New York,36087 ,Rockland County,73180,75791,150685,-2611,0.48564887,0.502976408,-0.017327538
New York,36089 ,St. Lawrence County,24608,19361,44907,5247,0.54797693,0.431135458,0.116841472
New York,36091 ,Saratoga County,61305,68471,132655,-7166,0.46213863,0.516158456,-0.054019826
New York,36093 ,Schenectady County,27544,31685,60591,-4141,0.454588965,0.522932449,-0.068343483
New York,36095 ,Schoharie County,9903,5345,15710,4558,0.630362826,0.340229153,0.290133673
New York,36097 ,Schuyler County,5621,3903,9766,1718,0.575568298,0.399651853,0.175916445
New York,36099 ,Seneca County,8329,6914,15630,1415,0.532885477,0.442354447,0.09053103
New York,36101 ,Steuben County,26781,11299,38797,15482,0.690285331,0.291233858,0.399051473
New York,36103 ,Suffolk County,333617,259463,601261,74154,0.554862198,0.431531398,0.1233308
New York,36105 ,Sullivan County,15555,10995,26931,4560,0.577587167,0.408265568,0.1693216
New York,36107 ,Tioga County,14616,9498,24769,5118,0.590092454,0.3834632,0.206629254
New York,36109 ,Tompkins County,9644,22627,33142,-12983,0.290990284,0.682728864,-0.391738579
New York,36111 ,Ulster County,33580,42606,77667,-9026,0.432358659,0.548572753,-0.116214094
New York,36113 ,Warren County,17699,17642,36131,57,0.489856356,0.488278763,0.001577593
New York,36115 ,Washington County,14577,8537,23607,6040,0.617486339,0.361630025,0.255856314
New York,36117 ,Wayne County,23734,12799,37425,10935,0.634175017,0.341990648,0.292184369
New York,36119 ,Westchester County,126013,220963,350749,-94950,0.359268309,0.629974711,-0.270706403
New York,36121 ,Wyoming County,13897,5073,19431,8824,0.715197365,0.261077659,0.454119706
New York,36123 ,Yates County,6208,4217,10741,1991,0.577972256,0.392607765,0.185364491
North Carolina,37001 ,Alamance County,46056,38825,86091,7231,0.534968812,0.450976293,0.08399252
North Carolina,37003 ,Alexander County,15888,4145,20236,11743,0.785135402,0.204832971,0.580302431
North Carolina,37005 ,Alleghany County,4527,1486,6076,3041,0.745062541,0.244568795,0.500493746
North Carolina,37007 ,Anson County,5321,5789,11194,-468,0.475343934,0.517152046,-0.041808111
North Carolina,37009 ,Ashe County,11451,4164,15814,7287,0.724105223,0.26331099,0.460794233
North Carolina,37011 ,Avery County,7172,2191,9458,4981,0.758299852,0.231655741,0.526644111
North Carolina,37013 ,Beaufort County,16437,9633,26315,6804,0.624624739,0.366064982,0.258559757
North Carolina,37015 ,Bertie County,3817,5939,9815,-2122,0.388894549,0.605094244,-0.216199694
North Carolina,37017 ,Bladen County,9676,7326,17125,2350,0.565021898,0.42779562,0.137226277
North Carolina,37019 ,Brunswick County,55850,33310,90175,22540,0.619351261,0.369392847,0.249958414
North Carolina,37021 ,Buncombe County,62412,96515,161569,-34103,0.386286973,0.59736088,-0.211073907
North Carolina,37023 ,Burke County,31019,13118,44602,17901,0.695462087,0.294112372,0.401349715
North Carolina,37025 ,Cabarrus County,63237,52162,117227,11075,0.539440573,0.44496575,0.094474822
North Carolina,37027 ,Caldwell County,32119,10245,42829,21874,0.749935791,0.239207079,0.510728712
North Carolina,37029 ,Camden County,4312,1537,5953,2775,0.724340669,0.258189148,0.46615152
North Carolina,37031 ,Carteret County,30028,12093,42695,17935,0.703314205,0.283241597,0.420072608
North Carolina,37033 ,Caswell County,7089,4860,12051,2229,0.588249938,0.403286034,0.184963903
North Carolina,37035 ,Catawba County,56588,25689,83425,30899,0.678309859,0.307929278,0.370380581
North Carolina,37037 ,Chatham County,21186,26787,48599,-5601,0.435934896,0.551184181,-0.115249285
North Carolina,37039 ,Cherokee County,12628,3583,16423,9045,0.768921634,0.21816964,0.550751994
North Carolina,37041 ,Chowan County,4471,3247,7784,1224,0.57438335,0.417137718,0.157245632
North Carolina,37043 ,Clay County,5112,1699,6893,3413,0.741621935,0.246481938,0.495139997
North Carolina,37045 ,Cleveland County,33798,16955,51308,16843,0.658727684,0.33045529,0.328272394
North Carolina,37047 ,Columbus County,16832,9446,26446,7386,0.636466762,0.35718067,0.279286092
North Carolina,37049 ,Craven County,31032,21148,53065,9884,0.584792236,0.398530105,0.186262131
North Carolina,37051 ,Cumberland County,60032,84469,147150,-24437,0.407964662,0.574033299,-0.166068637
North Carolina,37053 ,Currituck County,11657,4195,16147,7462,0.72192977,0.259800582,0.462129188
North Carolina,37055 ,Dare County,13938,9936,24232,4002,0.575189832,0.410036316,0.165153516
North Carolina,37057 ,Davidson County,64658,22636,88514,42022,0.730483313,0.255733556,0.474749757
North Carolina,37059 ,Davie County,18228,6713,25311,11515,0.720161195,0.265220655,0.45494054
North Carolina,37061 ,Duplin County,13793,8767,22715,5026,0.607219899,0.385956416,0.221263482
North Carolina,37063 ,Durham County,32459,144688,179914,-112229,0.180413976,0.804206454,-0.623792479
North Carolina,37065 ,Edgecombe County,9206,16089,25477,-6883,0.361345527,0.631510774,-0.270165247
North Carolina,37067 ,Forsyth County,85060,113029,201262,-27969,0.422633185,0.561601296,-0.138968111
North Carolina,37069 ,Franklin County,20904,15882,37357,5022,0.559573842,0.425141205,0.134432636
North Carolina,37071 ,Gaston County,73033,40959,115498,32074,0.632331296,0.354629517,0.277701778
North Carolina,37073 ,Gates County,3367,2546,5971,821,0.563892145,0.426394239,0.137497907
North Carolina,37075 ,Graham County,3710,905,4665,2805,0.79528403,0.193997856,0.601286174
North Carolina,37077 ,Granville County,16647,14565,31598,2082,0.526837142,0.460946895,0.065890246
North Carolina,37079 ,Greene County,4874,3832,8753,1042,0.556837656,0.437792757,0.119044899
North Carolina,37081 ,Guilford County,107294,173086,284486,-65792,0.377150369,0.608416583,-0.231266213
North Carolina,37083 ,Halifax County,10080,15545,25759,-5465,0.391319539,0.603478396,-0.212158857
North Carolina,37085 ,Harnett County,35177,22093,58293,13084,0.603451529,0.378999194,0.224452336
North Carolina,37087 ,Haywood County,22834,13144,36542,9690,0.624870013,0.359695693,0.26517432
North Carolina,37089 ,Henderson County,40032,27211,68371,12821,0.585511401,0.397990376,0.187521025
North Carolina,37091 ,Hertford County,3479,7097,10634,-3618,0.327158172,0.667387625,-0.340229453
North Carolina,37093 ,Hoke County,9453,11804,21639,-2351,0.436850132,0.545496557,-0.108646425
North Carolina,37095 ,Hyde County,1418,1046,2492,372,0.569020867,0.419743178,0.149277689
North Carolina,37097 ,Iredell County,67010,33888,102371,33122,0.65457991,0.331031249,0.323548661
North Carolina,37099 ,Jackson County,11356,9591,21428,1765,0.529960799,0.447591936,0.082368863
North Carolina,37101 ,Johnston County,68354,41261,111362,27093,0.61380004,0.370512383,0.243287656
North Carolina,37103 ,Jones County,3280,2197,5525,1083,0.593665158,0.397647059,0.1960181
North Carolina,37105 ,Lee County,16469,12143,29008,4326,0.567739934,0.41860866,0.149131274
North Carolina,37107 ,Lenoir County,14590,13605,28409,985,0.513569643,0.478897532,0.034672111
North Carolina,37109 ,Lincoln County,36341,13274,50217,23067,0.723679232,0.264332796,0.459346436
North Carolina,37111 ,McDowell County,16883,5832,23003,11051,0.733947746,0.253532148,0.480415598
North Carolina,37113 ,Macon County,14211,6230,20743,7981,0.685098587,0.300342284,0.384756303
North Carolina,37115 ,Madison County,7979,4901,13076,3078,0.610201897,0.37480881,0.235393087
North Carolina,37117 ,Martin County,6532,5911,12540,621,0.520893142,0.471371611,0.049521531
North Carolina,37119 ,Mecklenburg County,179211,378107,567053,-198896,0.316039241,0.666793051,-0.35075381
North Carolina,37121 ,Mitchell County,7090,1867,9041,5223,0.784205287,0.206503705,0.577701582
North Carolina,37123 ,Montgomery County,8411,4327,12849,4084,0.654603471,0.336757724,0.317845747
North Carolina,37125 ,Moore County,36764,20779,58339,15985,0.630178783,0.356176829,0.274001954
North Carolina,37127 ,Nash County,25827,25947,52271,-120,0.494098066,0.496393794,-0.002295728
North Carolina,37129 ,New Hanover County,63333,66146,131840,-2813,0.480377731,0.501714199,-0.021336468
North Carolina,37131 ,Northampton County,3989,6069,10109,-2080,0.394598872,0.600356118,-0.205757246
North Carolina,37133 ,Onslow County,46078,24266,72235,21812,0.637890219,0.335931335,0.301958884
North Carolina,37135 ,Orange County,20176,63594,84997,-43418,0.237373084,0.748191113,-0.510818029
North Carolina,37137 ,Pamlico County,4849,2713,7631,2136,0.635434412,0.355523522,0.27991089
North Carolina,37139 ,Pasquotank County,9770,9832,19897,-62,0.491028798,0.494144846,-0.003116048
North Carolina,37141 ,Pender County,21956,11723,34169,10233,0.642570751,0.343088765,0.299481987
North Carolina,37143 ,Perquimans County,4903,2492,7484,2411,0.655130946,0.332977018,0.322153928
North Carolina,37145 ,Person County,13184,8465,21894,4719,0.602174112,0.386635608,0.215538504
North Carolina,37147 ,Pitt County,38982,47252,87573,-8270,0.4451372,0.539572699,-0.0944355
North Carolina,37149 ,Polk County,7689,4518,12358,3171,0.622188056,0.365593138,0.256594918
North Carolina,37151 ,Randolph County,56894,15618,73316,41276,0.776010693,0.213023078,0.562987615
North Carolina,37153 ,Richmond County,11830,8754,20763,3076,0.569763522,0.421615374,0.148148148
North Carolina,37155 ,Robeson County,27806,19020,47188,8786,0.589259981,0.403068577,0.186191405
North Carolina,37157 ,Rockingham County,31301,15992,47809,15309,0.654709364,0.334497689,0.320211676
North Carolina,37159 ,Rowan County,49297,23114,73408,26183,0.67154806,0.314870314,0.356677746
North Carolina,37161 ,Rutherford County,24891,9135,34429,15756,0.722966104,0.265328647,0.457637457
North Carolina,37163 ,Sampson County,17411,10966,28618,6445,0.608393319,0.383185408,0.225207911
North Carolina,37165 ,Scotland County,7473,7186,14775,287,0.505786802,0.486362098,0.019424704
North Carolina,37167 ,Stanly County,25458,8129,33939,17329,0.750110492,0.239517959,0.510592534
North Carolina,37169 ,Stokes County,20143,5286,25702,14857,0.78371333,0.205664929,0.578048401
North Carolina,37171 ,Surry County,27538,8721,36638,18817,0.751623997,0.238031552,0.513592445
North Carolina,37173 ,Swain County,4161,2780,7068,1381,0.588709677,0.393322015,0.195387663
North Carolina,37175 ,Transylvania County,11636,8444,20404,3192,0.570280337,0.413840423,0.156439914
North Carolina,37177 ,Tyrrell County,1044,758,1817,286,0.574573473,0.417171161,0.157402312
North Carolina,37179 ,Union County,80382,48725,131011,31657,0.613551534,0.371915335,0.241636198
North Carolina,37181 ,Vance County,8391,12431,20999,-4040,0.399590457,0.591980571,-0.192390114
North Carolina,37183 ,Wake County,226197,393336,631830,-167139,0.358002944,0.622534543,-0.264531599
North Carolina,37185 ,Warren County,3752,6400,10293,-2648,0.364519576,0.621781793,-0.257262217
North Carolina,37187 ,Washington County,2781,3396,6205,-615,0.448186946,0.547300564,-0.099113618
North Carolina,37189 ,Watauga County,14451,17122,32220,-2671,0.448510242,0.531409063,-0.082898821
North Carolina,37191 ,Wayne County,30709,24215,55537,6494,0.552946684,0.436015629,0.116931055
North Carolina,37193 ,Wilkes County,27591,7510,35464,20081,0.778000226,0.211764042,0.566236183
North Carolina,37195 ,Wilson County,19581,20754,40735,-1173,0.480692279,0.509488155,-0.028795876
North Carolina,37197 ,Yadkin County,15933,3763,19923,12170,0.799728956,0.188877177,0.610851779
North Carolina,37199 ,Yancey County,7516,3688,11352,3828,0.662085976,0.324876674,0.337209302
North Dakota,38001 ,Adams County,981,258,1269,723,0.773049645,0.203309693,0.569739953
North Dakota,38003 ,Barnes County,3568,1820,5565,1748,0.641150045,0.327044025,0.31410602
North Dakota,38005 ,Benson County,1094,822,1961,272,0.557878633,0.419173891,0.138704742
North Dakota,38007 ,Billings County,541,72,635,469,0.851968504,0.113385827,0.738582677
North Dakota,38009 ,Bottineau County,2575,821,3471,1754,0.741861135,0.236531259,0.505329876
North Dakota,38011 ,Bowman County,1395,228,1657,1167,0.841882921,0.137598069,0.704284852
North Dakota,38013 ,Burke County,994,137,1155,857,0.860606061,0.118614719,0.741991342
North Dakota,38015 ,Burleigh County,34744,14348,50753,20396,0.68457037,0.2827025,0.40186787
North Dakota,38017 ,Cass County,42619,40311,86053,2308,0.495264546,0.468443866,0.02682068
North Dakota,38019 ,Cavalier County,1499,474,2020,1025,0.742079208,0.234653465,0.507425743
North Dakota,38021 ,Dickey County,1742,608,2424,1134,0.718646865,0.250825083,0.467821782
North Dakota,38023 ,Divide County,904,265,1202,639,0.752079867,0.22046589,0.531613977
North Dakota,38025 ,Dunn County,1951,342,2338,1609,0.834473909,0.146278871,0.688195038
North Dakota,38027 ,Eddy County,854,383,1261,471,0.677240285,0.303727201,0.373513085
North Dakota,38029 ,Emmons County,1738,237,2009,1501,0.865107018,0.117969139,0.74713788
North Dakota,38031 ,Foster County,1362,373,1778,989,0.766029246,0.209786277,0.55624297
North Dakota,38033 ,Golden Valley County,871,137,1026,734,0.848927875,0.133528265,0.71539961
North Dakota,38035 ,Grand Forks County,16987,12880,30970,4107,0.548498547,0.415886342,0.132612205
North Dakota,38037 ,Grant County,1145,207,1381,938,0.829109341,0.149891383,0.679217958
North Dakota,38039 ,Griggs County,907,308,1250,599,0.7256,0.2464,0.4792
North Dakota,38041 ,Hettinger County,1091,196,1312,895,0.831554878,0.149390244,0.682164634
North Dakota,38043 ,Kidder County,1215,221,1460,994,0.832191781,0.151369863,0.680821918
North Dakota,38045 ,LaMoure County,1645,527,2219,1118,0.741324921,0.237494367,0.503830554
North Dakota,38047 ,Logan County,930,128,1076,802,0.864312268,0.118959108,0.74535316
North Dakota,38049 ,McHenry County,2364,564,3003,1800,0.787212787,0.187812188,0.599400599
North Dakota,38051 ,McIntosh County,1153,261,1455,892,0.792439863,0.179381443,0.613058419
North Dakota,38053 ,McKenzie County,4482,814,5419,3668,0.827089869,0.150212216,0.676877653
North Dakota,38055 ,McLean County,4198,1230,5536,2968,0.758309249,0.222182081,0.536127168
North Dakota,38057 ,Mercer County,3856,704,4675,3152,0.824812834,0.150588235,0.674224599
North Dakota,38059 ,Morton County,12243,3872,16619,8371,0.736686925,0.232986341,0.503700584
North Dakota,38061 ,Mountrail County,2824,1256,4165,1568,0.678031212,0.301560624,0.376470588
North Dakota,38063 ,Nelson County,1141,586,1777,555,0.642093416,0.329769274,0.312324142
North Dakota,38065 ,Oliver County,918,129,1066,789,0.861163227,0.121013133,0.740150094
North Dakota,38067 ,Pembina County,2460,786,3331,1674,0.738516962,0.235965176,0.502551786
North Dakota,38069 ,Pierce County,1585,497,2128,1088,0.744830827,0.233552632,0.511278195
North Dakota,38071 ,Ramsey County,3577,1639,5372,1938,0.665860015,0.305100521,0.360759494
North Dakota,38073 ,Ransom County,1418,945,2454,473,0.577832111,0.385085575,0.192746536
North Dakota,38075 ,Renville County,1065,220,1319,845,0.807429871,0.166793025,0.640636846
North Dakota,38077 ,Richland County,5072,2510,7812,2562,0.649257552,0.321300563,0.327956989
North Dakota,38079 ,Rolette County,1257,2482,3804,-1225,0.33044164,0.652471083,-0.322029443
North Dakota,38081 ,Sargent County,1266,738,2070,528,0.611594203,0.356521739,0.255072464
North Dakota,38083 ,Sheridan County,688,104,812,584,0.84729064,0.128078818,0.719211823
North Dakota,38085 ,Sioux County,258,804,1186,-546,0.217537943,0.677908938,-0.460370995
North Dakota,38087 ,Slope County,380,44,427,336,0.889929742,0.103044496,0.786885246
North Dakota,38089 ,Stark County,12110,2499,15050,9611,0.804651163,0.166046512,0.638604651
North Dakota,38091 ,Steele County,652,392,1088,260,0.599264706,0.360294118,0.238970588
North Dakota,38093 ,Stutsman County,6994,2676,9959,4318,0.702279345,0.268701677,0.433577668
North Dakota,38095 ,Towner County,830,317,1174,513,0.706984668,0.270017036,0.436967632
North Dakota,38097 ,Traill County,2522,1493,4136,1029,0.609767892,0.360976789,0.248791103
North Dakota,38099 ,Walsh County,3324,1333,4783,1991,0.694961321,0.278695379,0.416265942
North Dakota,38101 ,Ward County,19974,7293,28246,12681,0.707144374,0.258195851,0.448948524
North Dakota,38103 ,Wells County,1893,442,2374,1451,0.797388374,0.186183656,0.611204718
North Dakota,38105 ,Williams County,11739,2169,14334,9570,0.818961909,0.151318543,0.667643365
Ohio,39001 ,Adams County,9870,2156,12145,7714,0.812680115,0.177521614,0.635158501
Ohio,39003 ,Allen County,33116,14149,48099,18967,0.688496642,0.29416412,0.394332523
Ohio,39005 ,Ashland County,19407,6541,26405,12866,0.734974437,0.247718235,0.487256201
Ohio,39007 ,Ashtabula County,26890,16497,44237,10393,0.607862197,0.372923119,0.234939078
Ohio,39009 ,Athens County,10862,14772,26120,-3910,0.415849923,0.565543645,-0.149693721
Ohio,39011 ,Auglaize County,20798,4651,25822,16147,0.805437224,0.180117729,0.625319495
Ohio,39013 ,Belmont County,23560,9138,33141,14422,0.710901904,0.275730968,0.435170936
Ohio,39015 ,Brown County,16480,4380,21139,12100,0.779601684,0.207199962,0.572401722
Ohio,39017 ,Butler County,114392,69613,186675,44779,0.612786929,0.372910138,0.239876791
Ohio,39019 ,Carroll County,10745,3251,14233,7494,0.754935713,0.228412843,0.526522869
Ohio,39021 ,Champaign County,14589,5062,20003,9527,0.729340599,0.253062041,0.476278558
Ohio,39023 ,Clark County,39032,24076,64351,14956,0.606548461,0.3741356,0.232412861
Ohio,39025 ,Clermont County,74570,34092,110710,40478,0.673561557,0.307939662,0.365621895
Ohio,39027 ,Clinton County,15488,4697,20563,10791,0.753197491,0.228419978,0.524777513
Ohio,39029 ,Columbiana County,35726,13359,49960,22367,0.715092074,0.267393915,0.447698159
Ohio,39031 ,Coshocton County,12325,4125,16768,8200,0.735031011,0.246004294,0.489026718
Ohio,39033 ,Crawford County,15436,4916,20713,10520,0.745232463,0.237338869,0.507893593
Ohio,39035 ,Cuyahoga County,202699,416176,627160,-213477,0.323201416,0.663588239,-0.340386823
Ohio,39037 ,Darke County,22003,4731,27160,17272,0.810125184,0.174189985,0.635935199
Ohio,39039 ,Defiance County,13038,5981,19381,7057,0.672720706,0.308601207,0.364119498
Ohio,39041 ,Delaware County,66356,57735,126318,8621,0.52530914,0.457060751,0.068248389
Ohio,39043 ,Erie County,22160,17493,40416,4667,0.548297704,0.432823634,0.11547407
Ohio,39045 ,Fairfield County,49714,30634,81564,19080,0.609509097,0.375582365,0.233926732
Ohio,39047 ,Fayette County,9473,2975,12626,6498,0.750277206,0.235624901,0.514652305
Ohio,39049 ,Franklin County,211237,409144,632532,-197907,0.333954646,0.646835259,-0.312880613
Ohio,39051 ,Fulton County,15731,6664,22801,9067,0.68992588,0.292267883,0.397657997
Ohio,39053 ,Gallia County,10645,2990,13799,7655,0.771432713,0.216682368,0.554750344
Ohio,39055 ,Geauga County,34143,21201,56021,12942,0.609467878,0.378447368,0.23102051
Ohio,39057 ,Greene County,52072,34798,88643,17274,0.587434992,0.392563429,0.194871563
Ohio,39059 ,Guernsey County,13407,4577,18264,8830,0.734067017,0.250602278,0.483464739
Ohio,39061 ,Hamilton County,177886,246266,430929,-68380,0.41279654,0.571476972,-0.158680432
Ohio,39063 ,Hancock County,26310,11757,38771,14553,0.678599985,0.303242114,0.375357871
Ohio,39065 ,Hardin County,9949,3062,13247,6887,0.751037971,0.231146675,0.519891296
Ohio,39067 ,Harrison County,5792,1768,7663,4024,0.755839749,0.23071904,0.52512071
Ohio,39069 ,Henry County,10479,4062,14788,6417,0.708615093,0.274682175,0.433932919
Ohio,39071 ,Highland County,15678,3799,19676,11879,0.796808294,0.193077861,0.603730433
Ohio,39073 ,Hocking County,9737,3880,13855,5857,0.70277878,0.280043306,0.422735475
Ohio,39075 ,Holmes County,10796,1994,12978,8802,0.831869317,0.153644629,0.678224688
Ohio,39077 ,Huron County,18956,7759,27190,11197,0.697168076,0.285362266,0.411805811
Ohio,39079 ,Jackson County,11309,3311,14810,7998,0.763605672,0.223565159,0.540040513
Ohio,39081 ,Jefferson County,22828,10018,33370,12810,0.684087504,0.300209769,0.383877734
Ohio,39083 ,Knox County,22340,8589,31459,13751,0.710130646,0.273022029,0.437108618
Ohio,39085 ,Lake County,73278,55514,130782,17764,0.560306464,0.424477375,0.13582909
Ohio,39087 ,Lawrence County,20306,7489,28123,12817,0.722042456,0.266294492,0.455747964
Ohio,39089 ,Licking County,59514,33055,94396,26459,0.63047163,0.350173736,0.280297894
Ohio,39091 ,Logan County,17964,5055,23409,12909,0.767397155,0.215942586,0.551454569
Ohio,39093 ,Lorain County,79520,75667,157768,3853,0.504031236,0.4796093,0.024421936
Ohio,39095 ,Lucas County,81763,115411,200559,-33648,0.407675547,0.575446627,-0.16777108
Ohio,39097 ,Madison County,13835,5698,19887,8137,0.695680595,0.286518831,0.409161764
Ohio,39099 ,Mahoning County,59903,57641,119190,2262,0.502584109,0.483606007,0.018978102
Ohio,39101 ,Marion County,19023,8269,27871,10754,0.682537404,0.296688314,0.38584909
Ohio,39103 ,Medina County,64598,39800,106041,24798,0.609179468,0.375326525,0.233852944
Ohio,39105 ,Meigs County,8316,2492,10967,5824,0.758274824,0.227227136,0.531047689
Ohio,39107 ,Mercer County,19145,3981,23426,15164,0.817254333,0.169939384,0.647314949
Ohio,39109 ,Miami County,41371,15663,58077,25708,0.712347401,0.269693683,0.442653718
Ohio,39111 ,Monroe County,5463,1605,7159,3858,0.763095404,0.224193323,0.538902081
Ohio,39113 ,Montgomery County,129034,135064,269164,-6030,0.479388031,0.50179073,-0.022402699
Ohio,39115 ,Morgan County,5041,1725,6856,3316,0.735268378,0.251604434,0.483663944
Ohio,39117 ,Morrow County,14077,4048,18457,10029,0.762691662,0.219320583,0.543371079
Ohio,39119 ,Muskingum County,27867,11971,40467,15896,0.688635184,0.295821286,0.392813898
Ohio,39121 ,Noble County,5135,1170,6348,3965,0.808916194,0.184310019,0.624606175
Ohio,39123 ,Ottawa County,14628,9008,24046,5620,0.608334026,0.374615321,0.233718706
Ohio,39125 ,Paulding County,7086,2213,9484,4873,0.7471531,0.233340363,0.513812737
Ohio,39127 ,Perry County,12357,4098,16676,8259,0.741005037,0.245742384,0.495262653
Ohio,39129 ,Pickaway County,20593,7304,28314,13289,0.727308045,0.257964258,0.469343788
Ohio,39131 ,Pike County,9157,3110,12424,6047,0.737041211,0.250321958,0.486719253
Ohio,39133 ,Portage County,45990,35661,83022,10329,0.553949556,0.429536749,0.124412806
Ohio,39135 ,Preble County,17022,4493,21840,12529,0.779395604,0.205723443,0.573672161
Ohio,39137 ,Putnam County,16412,3195,19947,13217,0.822780368,0.160174462,0.662605906
Ohio,39139 ,Richland County,41472,17640,59975,23832,0.69148812,0.294122551,0.397365569
Ohio,39141 ,Ross County,22278,10557,33365,11721,0.66770568,0.316409411,0.351296269
Ohio,39143 ,Sandusky County,18896,10596,30126,8300,0.627232291,0.351722764,0.275509527
Ohio,39145 ,Scioto County,22609,9080,32051,13529,0.705407008,0.283298493,0.422108515
Ohio,39147 ,Seneca County,17086,8266,25848,8820,0.661018261,0.319792634,0.341225627
Ohio,39149 ,Shelby County,20422,4465,25293,15957,0.807417072,0.176531056,0.630886016
Ohio,39151 ,Stark County,111097,75904,190093,35193,0.584434987,0.39929929,0.185135697
Ohio,39153 ,Summit County,124833,151668,281280,-26835,0.443803328,0.539206485,-0.095403157
Ohio,39155 ,Trumbull County,55194,44519,101152,10675,0.545654065,0.44011982,0.105534245
Ohio,39157 ,Tuscarawas County,30458,12889,44087,17569,0.690861252,0.292353755,0.398507497
Ohio,39159 ,Union County,21669,11141,33535,10528,0.646160728,0.332220069,0.313940659
Ohio,39161 ,Van Wert County,11650,3067,14994,8583,0.776977458,0.204548486,0.572428972
Ohio,39163 ,Vinton County,4525,1306,5902,3219,0.766689258,0.221280922,0.545408336
Ohio,39165 ,Warren County,87988,46069,136441,41919,0.644879472,0.337647774,0.307231697
Ohio,39167 ,Washington County,22307,9243,32031,13064,0.696419094,0.288564203,0.407854891
Ohio,39169 ,Wayne County,36759,16660,54280,20099,0.677210759,0.306927045,0.370283714
Ohio,39171 ,Williams County,13452,4842,18649,8610,0.72132554,0.259638587,0.461686954
Ohio,39173 ,Wood County,35757,30617,67651,5140,0.528550945,0.452572763,0.075978182
Ohio,39175 ,Wyandot County,8462,2733,11403,5729,0.742085416,0.23967377,0.502411646
Oklahoma,40001 ,Adair County,5585,1387,7108,4198,0.785734384,0.195132245,0.590602138
Oklahoma,40003 ,Alfalfa County,1978,232,2262,1746,0.874447392,0.102564103,0.771883289
Oklahoma,40005 ,Atoka County,4557,765,5389,3792,0.845611431,0.141955836,0.703655595
Oklahoma,40007 ,Beaver County,1968,190,2178,1778,0.903581267,0.087235996,0.816345271
Oklahoma,40009 ,Beckham County,6767,1048,7948,5719,0.85140916,0.131857071,0.719552089
Oklahoma,40011 ,Blaine County,3136,688,3901,2448,0.803896437,0.176365035,0.627531402
Oklahoma,40013 ,Bryan County,12344,3323,15976,9021,0.772658988,0.207999499,0.564659489
Oklahoma,40015 ,Caddo County,7013,2670,9859,4343,0.711329749,0.270818541,0.440511208
Oklahoma,40017 ,Canadian County,43550,16742,61940,26808,0.703099774,0.270293833,0.432805941
Oklahoma,40019 ,Carter County,14699,4470,19479,10229,0.754607526,0.229477899,0.525129627
Oklahoma,40021 ,Cherokee County,11223,6027,17714,5196,0.63356667,0.340239359,0.293327312
Oklahoma,40023 ,Choctaw County,4698,1082,5832,3616,0.805555556,0.185528121,0.620027435
Oklahoma,40025 ,Cimarron County,970,70,1054,900,0.920303605,0.066413662,0.853889943
Oklahoma,40027 ,Cleveland County,66677,49827,119778,16850,0.556671509,0.41599459,0.140676919
Oklahoma,40029 ,Coal County,2091,374,2524,1717,0.82844691,0.148177496,0.680269414
Oklahoma,40031 ,Comanche County,20905,13747,35631,7158,0.586708204,0.385815722,0.200892481
Oklahoma,40033 ,Cotton County,2117,393,2572,1724,0.823094868,0.152799378,0.67029549
Oklahoma,40035 ,Craig County,4686,1217,6032,3469,0.776856764,0.201757294,0.575099469
Oklahoma,40037 ,Creek County,23294,6577,30505,16717,0.763612523,0.215603999,0.548008523
Oklahoma,40039 ,Custer County,8060,2369,10691,5691,0.753905154,0.221588252,0.532316902
Oklahoma,40041 ,Delaware County,13557,3472,17245,10085,0.78614091,0.20133372,0.58480719
Oklahoma,40043 ,Dewey County,2124,214,2359,1910,0.900381518,0.090716405,0.809665112
Oklahoma,40045 ,Ellis County,1688,162,1873,1526,0.901227977,0.086492258,0.814735718
Oklahoma,40047 ,Garfield County,16970,4919,22430,12051,0.756576014,0.219304503,0.537271511
Oklahoma,40049 ,Garvin County,8878,1865,10922,7013,0.812854789,0.170756272,0.642098517
Oklahoma,40051 ,Grady County,18538,4144,23101,14394,0.802476083,0.179386174,0.62308991
Oklahoma,40053 ,Grant County,1916,280,2226,1636,0.860736748,0.125786164,0.734950584
Oklahoma,40055 ,Greer County,1605,328,1973,1277,0.813482007,0.166244298,0.647237709
Oklahoma,40057 ,Harmon County,747,177,933,570,0.800643087,0.189710611,0.610932476
Oklahoma,40059 ,Harper County,1327,136,1487,1191,0.892400807,0.091459314,0.800941493
Oklahoma,40061 ,Haskell County,4165,783,5014,3382,0.830674112,0.156162744,0.674511368
Oklahoma,40063 ,Hughes County,3875,919,4857,2956,0.797817583,0.189211447,0.608606135
Oklahoma,40065 ,Jackson County,6392,1646,8221,4746,0.777520983,0.200218951,0.577302031
Oklahoma,40067 ,Jefferson County,2026,319,2385,1707,0.849475891,0.133752621,0.71572327
Oklahoma,40069 ,Johnston County,3441,738,4251,2703,0.809456598,0.17360621,0.635850388
Oklahoma,40071 ,Kay County,12834,4040,17249,8794,0.744043133,0.234216476,0.509826657
Oklahoma,40073 ,Kingfisher County,5521,854,6465,4667,0.853982985,0.132095901,0.721887084
Oklahoma,40075 ,Kiowa County,2673,699,3427,1974,0.779982492,0.203968486,0.576014006
Oklahoma,40077 ,Latimer County,3437,762,4249,2675,0.808896211,0.179336314,0.629559896
Oklahoma,40079 ,Le Flore County,15213,3299,18805,11914,0.808986972,0.175432066,0.633554906
Oklahoma,40081 ,Lincoln County,12013,2609,14888,9404,0.806891456,0.175241805,0.631649651
Oklahoma,40083 ,Logan County,15608,5455,21574,10153,0.723463428,0.252850654,0.470612775
Oklahoma,40085 ,Love County,3305,711,4076,2594,0.810843965,0.174435721,0.636408243
Oklahoma,40087 ,McClain County,15295,3582,19236,11713,0.795123726,0.18621335,0.608910376
Oklahoma,40089 ,McCurtain County,9485,1858,11467,7627,0.827156187,0.162030174,0.665126014
Oklahoma,40091 ,McIntosh County,6172,2031,8335,4141,0.740491902,0.243671266,0.496820636
Oklahoma,40093 ,Major County,3084,320,3467,2764,0.889529853,0.092298817,0.797231035
Oklahoma,40095 ,Marshall County,4891,1100,6064,3791,0.806563325,0.181398417,0.625164908
Oklahoma,40097 ,Mayes County,12749,3581,16626,9168,0.766811019,0.215385541,0.551425478
Oklahoma,40099 ,Murray County,4612,1156,5894,3456,0.782490668,0.196131659,0.586359009
Oklahoma,40101 ,Muskogee County,16526,8027,25081,8499,0.658905147,0.32004306,0.338862087
Oklahoma,40103 ,Noble County,3821,1003,4938,2818,0.773795059,0.203118672,0.570676387
Oklahoma,40105 ,Nowata County,3610,712,4391,2898,0.822136188,0.162149852,0.659986336
Oklahoma,40107 ,Okfuskee County,3058,896,4038,2162,0.757305597,0.221892026,0.535413571
Oklahoma,40109 ,Oklahoma County,145050,141724,294740,3326,0.492128656,0.480844134,0.011284522
Oklahoma,40111 ,Okmulgee County,9668,4357,14313,5311,0.675469853,0.30440858,0.371061273
Oklahoma,40113 ,Osage County,14121,6002,20538,8119,0.687554777,0.292238777,0.395316
Oklahoma,40115 ,Ottawa County,8545,2686,11438,5859,0.747071166,0.234831264,0.512239902
Oklahoma,40117 ,Pawnee County,5267,1363,6786,3904,0.776156793,0.200854701,0.575302093
Oklahoma,40119 ,Payne County,17813,10904,29643,6909,0.600917586,0.36784401,0.233073576
Oklahoma,40121 ,Pittsburg County,13851,3768,17924,10083,0.772762776,0.210220933,0.562541843
Oklahoma,40123 ,Pontotoc County,10805,4117,15320,6688,0.705287206,0.268733681,0.436553525
Oklahoma,40125 ,Pottawatomie County,20240,7275,28185,12965,0.718112471,0.258116019,0.459996452
Oklahoma,40127 ,Pushmataha County,4016,668,4739,3348,0.847436168,0.140958008,0.70647816
Oklahoma,40129 ,Roger Mills County,1629,168,1834,1461,0.888222465,0.091603053,0.796619411
Oklahoma,40131 ,Rogers County,34031,9589,44553,24442,0.763831841,0.215226809,0.548605032
Oklahoma,40133 ,Seminole County,6011,2150,8337,3861,0.721002759,0.25788653,0.463116229
Oklahoma,40135 ,Sequoyah County,12113,3035,15386,9078,0.787274145,0.197257247,0.590016898
Oklahoma,40137 ,Stephens County,15560,3154,19057,12406,0.816497875,0.16550349,0.650994385
Oklahoma,40139 ,Texas County,4505,894,5521,3611,0.815975367,0.161927187,0.65404818
Oklahoma,40141 ,Tillman County,2076,597,2708,1479,0.76661743,0.220457903,0.546159527
Oklahoma,40143 ,Tulsa County,150574,108996,266678,41578,0.564628503,0.40871763,0.155910874
Oklahoma,40145 ,Wagoner County,26165,8464,35338,17701,0.740421076,0.239515536,0.500905541
Oklahoma,40147 ,Washington County,17076,5790,23501,11286,0.726607378,0.246372495,0.480234884
Oklahoma,40149 ,Washita County,4086,598,4777,3488,0.855348545,0.125183169,0.730165376
Oklahoma,40151 ,Woods County,2993,591,3678,2402,0.813757477,0.160685155,0.653072322
Oklahoma,40153 ,Woodward County,6611,1005,7785,5606,0.849197174,0.129094412,0.720102762
Oregon,41001 ,Baker County,7352,2346,9932,5006,0.740233588,0.236206202,0.504027386
Oregon,41003 ,Benton County,14878,35827,52799,-20949,0.28178564,0.678554518,-0.396768878
Oregon,41005 ,Clackamas County,110509,139043,255728,-28534,0.432134925,0.543714415,-0.111579491
Oregon,41007 ,Clatsop County,10218,12916,23764,-2698,0.429978118,0.543511193,-0.113533075
Oregon,41009 ,Columbia County,17150,13835,32221,3315,0.532261569,0.429378356,0.102883213
Oregon,41011 ,Coos County,21829,14243,37075,7586,0.588779501,0.384167229,0.204612272
Oregon,41013 ,Crook County,11287,3801,15448,7486,0.730644744,0.246051269,0.484593475
Oregon,41015 ,Curry County,16969,12116,29851,4853,0.568456668,0.40588255,0.162574118
Oregon,41017 ,Deschutes County,55646,65962,125234,-10316,0.444336203,0.526709999,-0.082373796
Oregon,41019 ,Douglas County,43298,19160,64349,24138,0.672862049,0.297751325,0.375110724
Oregon,41021 ,Gilliam County,834,324,1178,510,0.707979626,0.275042445,0.432937182
Oregon,41023 ,Grant County,3545,929,4596,2616,0.771322889,0.202132289,0.569190601
Oregon,41025 ,Harney County,3475,894,4481,2581,0.775496541,0.199509038,0.575987503
Oregon,41027 ,Hood River County,3955,8764,13090,-4809,0.302139037,0.669518717,-0.367379679
Oregon,41029 ,Jackson County,63869,59478,126421,4391,0.505208787,0.470475633,0.034733154
Oregon,41031 ,Jefferson County,7189,4393,11913,2796,0.603458407,0.36875682,0.234701587
Oregon,41033 ,Josephine County,31751,18451,51641,13300,0.614840921,0.357293623,0.257547298
Oregon,41035 ,Klamath County,25308,10388,36556,14920,0.692307692,0.284166758,0.408140934
Oregon,41037 ,Lake County,3470,792,4363,2678,0.795324318,0.181526473,0.613797846
Oregon,41039 ,Lane County,80336,134366,222253,-54030,0.361461938,0.604563268,-0.24310133
Oregon,41041 ,Lincoln County,12460,17385,30726,-4925,0.405519755,0.565807459,-0.160287704
Oregon,41043 ,Linn County,43486,26512,72640,16974,0.598650881,0.364977974,0.233672907
Oregon,41045 ,Malheur County,8187,3260,11804,4927,0.693578448,0.276177567,0.417400881
Oregon,41047 ,Marion County,79002,80872,165534,-1870,0.477255428,0.488552201,-0.011296773
Oregon,41049 ,Morrow County,3586,1371,5118,2215,0.700664322,0.267878077,0.432786245
Oregon,41051 ,Multnomah County,82995,367249,463659,-284254,0.179000084,0.792067015,-0.613066931
Oregon,41053 ,Polk County,23732,22917,48291,815,0.491437328,0.474560477,0.016876851
Oregon,41055 ,Sherman County,921,260,1208,661,0.762417219,0.215231788,0.54718543
Oregon,41057 ,Tillamook County,8354,8066,16888,288,0.494670772,0.477617243,0.017053529
Oregon,41059 ,Umatilla County,21002,10499,32539,10503,0.645440856,0.322658963,0.322781892
Oregon,41061 ,Union County,10298,4254,14944,6044,0.689105996,0.284662741,0.404443255
Oregon,41063 ,Wallowa County,3404,1625,5149,1779,0.661099243,0.315595261,0.345503981
Oregon,41065 ,Wasco County,7035,6604,14130,431,0.497876858,0.467374381,0.030502477
Oregon,41067 ,Washington County,99035,209848,320194,-110813,0.309296864,0.655377677,-0.346080814
Oregon,41069 ,Wheeler County,711,217,965,494,0.736787565,0.224870466,0.511917098
Oregon,41071 ,Yamhill County,29551,27174,58923,2377,0.501518931,0.461178148,0.040340784
Pennsylvania,42001 ,Adams County,37523,18207,56540,19316,0.66365405,0.322019809,0.341634241
Pennsylvania,42003 ,Allegheny County,282324,429065,722493,-146741,0.390763648,0.593867345,-0.203103698
Pennsylvania,42005 ,Armstrong County,27489,8457,36370,19032,0.755815232,0.232526808,0.523288425
Pennsylvania,42007 ,Beaver County,54759,38122,94122,16637,0.581787467,0.405027517,0.17675995
Pennsylvania,42009 ,Bedford County,23025,4367,27574,18658,0.835025749,0.15837383,0.676651918
Pennsylvania,42011 ,Berks County,109736,92895,205540,16841,0.533891213,0.451955824,0.08193539
Pennsylvania,42013 ,Blair County,45306,17636,63595,27670,0.712414498,0.277317399,0.435097099
Pennsylvania,42015 ,Bradford County,21600,8046,30159,13554,0.716204118,0.266786034,0.449418084
Pennsylvania,42017 ,Bucks County,187367,204712,396234,-17345,0.472869567,0.516644205,-0.043774638
Pennsylvania,42019 ,Butler County,74359,37508,113305,36851,0.656272892,0.3310357,0.325237192
Pennsylvania,42021 ,Cambria County,48085,21730,70574,26355,0.681341571,0.307903761,0.37343781
Pennsylvania,42023 ,Cameron County,1771,634,2434,1137,0.727608874,0.260476582,0.467132293
Pennsylvania,42025 ,Carbon County,21984,11212,33629,10772,0.65372149,0.333402718,0.320318772
Pennsylvania,42027 ,Centre County,36372,40055,77493,-3683,0.469358523,0.516885396,-0.047526873
Pennsylvania,42029 ,Chester County,128565,182372,315753,-53807,0.407169528,0.577578044,-0.170408516
Pennsylvania,42031 ,Clarion County,14578,4678,19493,9900,0.747858206,0.239983584,0.507874622
Pennsylvania,42033 ,Clearfield County,29203,9673,39496,19530,0.739391331,0.244910877,0.494480454
Pennsylvania,42035 ,Clinton County,11902,5502,17625,6400,0.67529078,0.312170213,0.363120567
Pennsylvania,42037 ,Columbia County,20098,10532,31171,9566,0.644765968,0.337878156,0.306887812
Pennsylvania,42039 ,Crawford County,28559,12924,42004,15635,0.679911437,0.307684982,0.372226455
Pennsylvania,42041 ,Cumberland County,77212,62245,141595,14967,0.545301741,0.439598856,0.105702885
Pennsylvania,42043 ,Dauphin County,66408,78983,147368,-12575,0.450627002,0.535957603,-0.085330601
Pennsylvania,42045 ,Delaware County,118532,206423,327931,-87891,0.361454086,0.629470834,-0.268016747
Pennsylvania,42047 ,Elk County,12140,4522,16906,7618,0.718088253,0.267479002,0.450609251
Pennsylvania,42049 ,Erie County,66869,68286,137083,-1417,0.487799362,0.498136166,-0.010336803
Pennsylvania,42051 ,Fayette County,41227,20444,62139,20783,0.663464169,0.329004329,0.33445984
Pennsylvania,42053 ,Forest County,1882,728,2646,1154,0.711262283,0.275132275,0.436130008
Pennsylvania,42055 ,Franklin County,57245,22422,80783,34823,0.708626815,0.277558397,0.431068418
Pennsylvania,42057 ,Fulton County,6824,1085,7977,5739,0.855459446,0.136016046,0.7194434
Pennsylvania,42059 ,Greene County,12579,4911,17669,7668,0.71192484,0.277944422,0.433980418
Pennsylvania,42061 ,Huntingdon County,17061,5445,22792,11616,0.748552124,0.238899614,0.50965251
Pennsylvania,42063 ,Indiana County,28089,12634,41198,15455,0.681804942,0.306665372,0.37513957
Pennsylvania,42065 ,Jefferson County,17960,4527,22824,13433,0.786890992,0.198343849,0.588547143
Pennsylvania,42067 ,Juniata County,9649,2253,12043,7396,0.801212323,0.187079631,0.614132691
Pennsylvania,42069 ,Lackawanna County,52334,61991,115410,-9657,0.453461572,0.537137163,-0.083675591
Pennsylvania,42071 ,Lancaster County,160209,115847,281375,44362,0.569378943,0.411717459,0.157661484
Pennsylvania,42073 ,Lawrence County,29597,15978,46076,13619,0.642351767,0.346774894,0.295576873
Pennsylvania,42075 ,Lebanon County,46731,23932,71858,22799,0.650324251,0.333045729,0.317278522
Pennsylvania,42077 ,Lehigh County,84259,98288,184713,-14029,0.456161721,0.532111979,-0.075950258
Pennsylvania,42079 ,Luzerne County,86929,64873,153321,22056,0.566973865,0.423118816,0.143855049
Pennsylvania,42081 ,Lycoming County,41462,16971,59254,24491,0.699733351,0.286411044,0.413322307
Pennsylvania,42083 ,McKean County,14083,5098,19466,8985,0.723466557,0.261892531,0.461574027
Pennsylvania,42085 ,Mercer County,36143,21067,57954,15076,0.623649791,0.363512441,0.26013735
Pennsylvania,42087 ,Mifflin County,16670,4603,21502,12067,0.775276718,0.214073109,0.561203609
Pennsylvania,42089 ,Monroe County,38726,44060,83829,-5334,0.461964237,0.525593768,-0.063629532
Pennsylvania,42091 ,Montgomery County,185460,319511,510157,-134051,0.363535147,0.626299355,-0.262764208
Pennsylvania,42093 ,Montour County,5844,3771,9817,2073,0.595293878,0.384129571,0.211164307
Pennsylvania,42095 ,Northampton County,83854,85087,171399,-1233,0.489232726,0.496426467,-0.007193741
Pennsylvania,42097 ,Northumberland County,28952,12677,42283,16275,0.684719627,0.299813164,0.384906464
Pennsylvania,42099 ,Perry County,18293,5950,24652,12343,0.742049327,0.241359727,0.500689599
Pennsylvania,42101 ,Philadelphia County,132740,603790,741377,-471050,0.179045209,0.814416957,-0.635371747
Pennsylvania,42103 ,Pike County,19213,13019,32554,6194,0.59018861,0.399920133,0.190268477
Pennsylvania,42105 ,Potter County,7239,1726,9064,5513,0.798654016,0.190423654,0.608230362
Pennsylvania,42107 ,Schuylkill County,48871,20727,70603,28144,0.692194383,0.293571095,0.398623288
Pennsylvania,42109 ,Snyder County,13983,4910,19140,9073,0.730564263,0.256530825,0.474033438
Pennsylvania,42111 ,Somerset County,31466,8654,40543,22812,0.776114249,0.213452384,0.562661865
Pennsylvania,42113 ,Sullivan County,2619,921,3595,1698,0.728511822,0.256189152,0.47232267
Pennsylvania,42115 ,Susquehanna County,15207,6236,21752,8971,0.699108128,0.286686282,0.412421846
Pennsylvania,42117 ,Tioga County,15742,4955,21075,10787,0.746951364,0.235112693,0.511838671
Pennsylvania,42119 ,Union County,12356,7475,20115,4881,0.614267959,0.371613224,0.242654735
Pennsylvania,42121 ,Venango County,18569,7585,26528,10984,0.699977382,0.285924306,0.414053076
Pennsylvania,42123 ,Warren County,14237,6066,20650,8171,0.689443099,0.293753027,0.395690073
Pennsylvania,42125 ,Washington County,72080,45088,118478,26992,0.608382991,0.380560104,0.227822887
Pennsylvania,42127 ,Wayne County,18637,9191,28089,9446,0.663498167,0.32720994,0.336288227
Pennsylvania,42129 ,Westmoreland County,130218,72129,205183,58089,0.634643221,0.351534971,0.28310825
Pennsylvania,42131 ,Wyoming County,9936,4704,14858,5232,0.66873065,0.316597119,0.352133531
Pennsylvania,42133 ,York County,146733,88114,238471,58619,0.615307522,0.369495662,0.24581186
Rhode Island,44001 ,Bristol County,9745,18050,28239,-8305,0.345090124,0.63918694,-0.294096816
Rhode Island,44003 ,Kent County,42001,49113,92574,-7112,0.453701903,0.53052693,-0.076825026
Rhode Island,44005 ,Newport County,15722,29486,45901,-13764,0.342519771,0.642382519,-0.299862748
Rhode Island,44007 ,Providence County,102551,165012,271326,-62461,0.377962304,0.608168771,-0.230206467
Rhode Island,44009 ,Washington County,29818,44549,75587,-14731,0.394485824,0.589373834,-0.19488801
South Carolina,45001 ,Abbeville County,8215,4101,12433,4114,0.660741575,0.329847985,0.33089359
South Carolina,45003 ,Aiken County,51589,32275,85185,19314,0.605611317,0.378881258,0.226730058
South Carolina,45005 ,Allendale County,835,2718,3593,-1883,0.232396326,0.756470916,-0.524074589
South Carolina,45007 ,Anderson County,67565,27169,96093,40396,0.703120935,0.282736516,0.420384419
South Carolina,45009 ,Bamberg County,2417,4010,6482,-1593,0.372878741,0.618636223,-0.245757482
South Carolina,45011 ,Barnwell County,5492,4720,10321,772,0.532118981,0.457320027,0.074798954
South Carolina,45013 ,Beaufort County,53194,43419,97835,9775,0.543711351,0.443798232,0.099913119
South Carolina,45015 ,Berkeley County,57397,45223,104458,12174,0.54947443,0.432929981,0.116544448
South Carolina,45017 ,Calhoun County,4305,3905,8291,400,0.519237728,0.470992643,0.048245085
South Carolina,45019 ,Charleston County,93297,121485,218857,-28188,0.426292054,0.555088482,-0.128796429
South Carolina,45021 ,Cherokee County,18043,6983,25270,11060,0.714008706,0.276335576,0.43767313
South Carolina,45023 ,Chester County,8660,6941,15757,1719,0.549597005,0.440502634,0.109094371
South Carolina,45025 ,Chesterfield County,11297,7431,18876,3866,0.598484848,0.393674507,0.204810341
South Carolina,45027 ,Clarendon County,8361,8250,16733,111,0.499671308,0.49303771,0.006633598
South Carolina,45029 ,Colleton County,10440,8602,19283,1838,0.541409532,0.446092413,0.095317119
South Carolina,45031 ,Darlington County,16832,15220,32417,1612,0.519233735,0.46950674,0.049726995
South Carolina,45033 ,Dillon County,6582,6436,13101,146,0.502404397,0.491260209,0.011144187
South Carolina,45035 ,Dorchester County,41913,33824,77278,8089,0.542366521,0.437692487,0.104674034
South Carolina,45037 ,Edgefield County,8184,4953,13304,3231,0.615153337,0.372294047,0.24285929
South Carolina,45039 ,Fairfield County,4625,7382,12136,-2757,0.381097561,0.608272907,-0.227175346
South Carolina,45041 ,Florence County,32615,31153,64510,1462,0.50558053,0.482917377,0.022663153
South Carolina,45043 ,Georgetown County,20487,15822,36668,4665,0.558716047,0.4314934,0.127222646
South Carolina,45045 ,Greenville County,150021,103030,258155,46991,0.581127617,0.399101315,0.182026302
South Carolina,45047 ,Greenwood County,19431,12145,32006,7286,0.607104918,0.379460101,0.227644817
South Carolina,45049 ,Hampton County,3906,5323,9305,-1417,0.419774315,0.572058033,-0.152283718
South Carolina,45051 ,Horry County,118821,59180,179744,59641,0.661056836,0.329246039,0.331810798
South Carolina,45053 ,Jasper County,7078,7185,14394,-107,0.491732666,0.499166319,-0.007433653
South Carolina,45055 ,Kershaw County,20471,12699,33629,7772,0.60873056,0.377620506,0.231110054
South Carolina,45057 ,Lancaster County,30312,18937,49868,11375,0.60784471,0.37974252,0.22810219
South Carolina,45059 ,Laurens County,20004,10159,30488,9845,0.656127001,0.333213067,0.322913933
South Carolina,45061 ,Lee County,3008,5329,8431,-2321,0.356778555,0.632072115,-0.275293559
South Carolina,45063 ,Lexington County,92817,49301,144568,43516,0.642030048,0.34102291,0.301007139
South Carolina,45065 ,McCormick County,2958,2687,5697,271,0.519220642,0.471651747,0.047568896
South Carolina,45067 ,Marion County,5711,8872,14704,-3161,0.388397715,0.603373232,-0.214975517
South Carolina,45069 ,Marlboro County,5044,6290,11446,-1246,0.440677966,0.549536956,-0.10885899
South Carolina,45071 ,Newberry County,11443,6958,18631,4485,0.614191401,0.373463582,0.240727819
South Carolina,45073 ,Oconee County,29698,10414,40668,19284,0.730254746,0.256073571,0.474181174
South Carolina,45075 ,Orangeburg County,13603,27295,41205,-13692,0.330129839,0.662419609,-0.332289771
South Carolina,45077 ,Pickens County,42907,13645,57546,29262,0.745612206,0.237114656,0.50849755
South Carolina,45079 ,Richland County,58313,132570,193822,-74257,0.30085852,0.683978083,-0.383119563
South Carolina,45081 ,Saluda County,6210,2963,9274,3247,0.669613975,0.319495363,0.350118611
South Carolina,45083 ,Spartanburg County,93560,52926,148655,40634,0.629376745,0.356032424,0.273344321
South Carolina,45085 ,Sumter County,21000,27379,48920,-6379,0.429272281,0.559668847,-0.130396566
South Carolina,45087 ,Union County,8183,4935,13257,3248,0.617258807,0.372256167,0.24500264
South Carolina,45089 ,Williamsburg County,5532,10289,15985,-4757,0.346074445,0.643665937,-0.297591492
South Carolina,45091 ,York County,82727,59008,144050,23719,0.574293648,0.409635543,0.164658105
South Dakota,46003 ,Aurora County,1052,317,1405,735,0.748754448,0.225622776,0.523131673
South Dakota,46005 ,Beadle County,4808,2107,7081,2701,0.679000141,0.297556842,0.381443299
South Dakota,46007 ,Bennett County,694,466,1183,228,0.586644125,0.393913779,0.192730347
South Dakota,46009 ,Bon Homme County,2235,721,3001,1514,0.744751749,0.240253249,0.5044985
South Dakota,46011 ,Brookings County,8000,6110,14567,1890,0.549186517,0.419441203,0.129745315
South Dakota,46013 ,Brown County,10580,6538,17547,4042,0.602952072,0.372599305,0.230352767
South Dakota,46015 ,Brule County,1750,673,2490,1077,0.702811245,0.270281124,0.43253012
South Dakota,46017 ,Buffalo County,183,352,549,-169,0.333333333,0.641165756,-0.307832423
South Dakota,46019 ,Butte County,3731,939,4802,2792,0.77696793,0.195543524,0.581424406
South Dakota,46021 ,Campbell County,747,117,873,630,0.855670103,0.134020619,0.721649485
South Dakota,46023 ,Charles Mix County,2552,1177,3783,1375,0.674596881,0.311128734,0.363468147
South Dakota,46025 ,Clark County,1373,437,1850,936,0.742162162,0.236216216,0.505945946
South Dakota,46027 ,Clay County,2456,3083,5698,-627,0.431028431,0.541067041,-0.11003861
South Dakota,46029 ,Codington County,8958,3837,13161,5121,0.680647367,0.291543196,0.389104171
South Dakota,46031 ,Corson County,647,622,1283,25,0.504286828,0.484801247,0.019485581
South Dakota,46033 ,Custer County,3852,1522,5494,2330,0.701128504,0.277029487,0.424099017
South Dakota,46035 ,Davison County,5613,2648,8454,2965,0.663946061,0.313224509,0.350721552
South Dakota,46037 ,Day County,1869,1052,2964,817,0.630566802,0.354925776,0.275641026
South Dakota,46039 ,Deuel County,1699,609,2350,1090,0.722978723,0.259148936,0.463829787
South Dakota,46041 ,Dewey County,790,1131,1966,-341,0.401831129,0.575279756,-0.173448627
South Dakota,46043 ,Douglas County,1468,216,1707,1252,0.859988284,0.126537786,0.733450498
South Dakota,46045 ,Edmunds County,1538,417,1985,1121,0.774811083,0.210075567,0.564735516
South Dakota,46047 ,Fall River County,2878,1053,4042,1825,0.712023751,0.260514597,0.451509154
South Dakota,46049 ,Faulk County,964,198,1182,766,0.815566836,0.16751269,0.648054146
South Dakota,46051 ,Grant County,2618,1056,3745,1562,0.699065421,0.281975968,0.417089453
South Dakota,46053 ,Gregory County,1771,455,2258,1316,0.784322409,0.201505757,0.582816652
South Dakota,46055 ,Haakon County,1026,105,1137,921,0.90237467,0.092348285,0.810026385
South Dakota,46057 ,Hamlin County,2372,647,3083,1725,0.769380474,0.209860525,0.559519948
South Dakota,46059 ,Hand County,1433,373,1836,1060,0.780501089,0.203159041,0.577342048
South Dakota,46061 ,Hanson County,1793,557,2388,1236,0.750837521,0.233249581,0.51758794
South Dakota,46063 ,Harding County,748,49,813,699,0.9200492,0.060270603,0.859778598
South Dakota,46065 ,Hughes County,5522,2953,8723,2569,0.633039092,0.338530322,0.29450877
South Dakota,46067 ,Hutchinson County,2944,762,3767,2182,0.781523759,0.202282984,0.579240775
South Dakota,46069 ,Hyde County,564,136,710,428,0.794366197,0.191549296,0.602816901
South Dakota,46071 ,Jackson County,738,359,1115,379,0.661883408,0.321973094,0.339910314
South Dakota,46073 ,Jerauld County,721,270,1006,451,0.716699801,0.268389662,0.448310139
South Dakota,46075 ,Jones County,498,90,599,408,0.831385643,0.150250417,0.681135225
South Dakota,46077 ,Kingsbury County,1904,819,2779,1085,0.685138539,0.294710327,0.390428212
South Dakota,46079 ,Lake County,3681,2068,5873,1613,0.626766559,0.352119871,0.274646688
South Dakota,46081 ,Lawrence County,8753,4537,13828,4216,0.632991033,0.328102401,0.304888632
South Dakota,46083 ,Lincoln County,19617,11981,32396,7636,0.605537721,0.369829609,0.235708112
South Dakota,46085 ,Lyman County,1042,525,1597,517,0.652473388,0.32874139,0.323731997
South Dakota,46087 ,McCook County,2068,769,2900,1299,0.713103448,0.265172414,0.447931034
South Dakota,46089 ,McPherson County,1075,222,1324,853,0.811933535,0.167673716,0.644259819
South Dakota,46091 ,Marshall County,1287,858,2178,429,0.590909091,0.393939394,0.196969697
South Dakota,46093 ,Meade County,9875,3285,13670,6590,0.722384784,0.240307242,0.482077542
South Dakota,46095 ,Mellette County,449,298,769,151,0.583875163,0.387516255,0.196358908
South Dakota,46097 ,Miner County,787,320,1138,467,0.691564148,0.281195079,0.410369069
South Dakota,46099 ,Minnehaha County,49249,40482,92326,8767,0.533425037,0.438468037,0.094957
South Dakota,46101 ,Moody County,1951,1179,3206,772,0.608546475,0.367747973,0.240798503
South Dakota,46102 ,Oglala Lakota County,297,2829,3200,-2532,0.0928125,0.8840625,-0.79125
South Dakota,46103 ,Pennington County,35063,20606,57518,14457,0.609600473,0.358253069,0.251347404
South Dakota,46105 ,Perkins County,1401,239,1669,1162,0.839424805,0.143199521,0.696225285
South Dakota,46107 ,Potter County,1139,227,1380,912,0.825362319,0.164492754,0.660869565
South Dakota,46109 ,Roberts County,2404,1828,4307,576,0.558161133,0.424425354,0.133735779
South Dakota,46111 ,Sanborn County,905,257,1185,648,0.76371308,0.216877637,0.546835443
South Dakota,46115 ,Spink County,2104,998,3163,1106,0.665191274,0.315523237,0.349668037
South Dakota,46117 ,Stanley County,1203,421,1652,782,0.728208232,0.254842615,0.473365617
South Dakota,46119 ,Sully County,726,185,930,541,0.780645161,0.198924731,0.58172043
South Dakota,46121 ,Todd County,532,1963,2539,-1431,0.209531312,0.773139031,-0.56360772
South Dakota,46123 ,Tripp County,2161,495,2696,1666,0.801557864,0.183605341,0.617952522
South Dakota,46125 ,Turner County,3290,1139,4548,2151,0.723394899,0.250439754,0.472955145
South Dakota,46127 ,Union County,5944,2725,8855,3219,0.671259176,0.307735743,0.363523433
South Dakota,46129 ,Walworth County,1966,565,2580,1401,0.762015504,0.218992248,0.543023256
South Dakota,46135 ,Yankton County,6581,4016,10900,2565,0.603761468,0.368440367,0.235321101
South Dakota,46137 ,Ziebach County,404,481,906,-77,0.445916115,0.530905077,-0.084988962
Tennessee,47001 ,Anderson County,23163,11733,35527,11430,0.651982999,0.330255862,0.321727137
Tennessee,47003 ,Bedford County,14317,4443,19039,9874,0.751982772,0.233363097,0.518619675
Tennessee,47005 ,Benton County,5661,1526,7250,4135,0.780827586,0.210482759,0.570344828
Tennessee,47007 ,Bledsoe County,4725,971,5758,3754,0.82059743,0.168634943,0.651962487
Tennessee,47009 ,Blount County,47195,17834,66306,29361,0.711775707,0.268965101,0.442810605
Tennessee,47011 ,Bradley County,35194,9849,45968,25345,0.765619561,0.214257745,0.551361817
Tennessee,47013 ,Campbell County,12330,2438,14929,9892,0.825909304,0.163306317,0.662602987
Tennessee,47015 ,Cannon County,5190,1261,6562,3929,0.790917403,0.192167022,0.598750381
Tennessee,47017 ,Carroll County,9194,2558,11893,6636,0.773059783,0.215084503,0.55797528
Tennessee,47019 ,Carter County,19873,4613,24868,15260,0.799139456,0.185499437,0.613640019
Tennessee,47021 ,Cheatham County,14328,5457,20091,8871,0.713155144,0.271614156,0.441540989
Tennessee,47023 ,Chester County,5951,1411,7578,4540,0.785299551,0.186196886,0.599102666
Tennessee,47025 ,Claiborne County,10598,2201,12935,8397,0.819327406,0.170158485,0.649168922
Tennessee,47027 ,Clay County,2733,735,3506,1998,0.779520821,0.209640616,0.569880205
Tennessee,47029 ,Cocke County,12182,2524,14870,9658,0.819233356,0.169737727,0.649495629
Tennessee,47031 ,Coffee County,17863,5704,24313,12159,0.734709826,0.234607,0.500102826
Tennessee,47033 ,Crockett County,4673,1382,6114,3291,0.764311416,0.2260386,0.538272816
Tennessee,47035 ,Cumberland County,25167,6728,32307,18439,0.778995264,0.208252082,0.570743183
Tennessee,47037 ,Davidson County,99415,197846,308325,-98431,0.322435742,0.641680045,-0.319244304
Tennessee,47039 ,Decatur County,4229,904,5250,3325,0.80552381,0.172190476,0.633333333
Tennessee,47041 ,DeKalb County,6663,1747,8501,4916,0.783790142,0.205505235,0.578284908
Tennessee,47043 ,Dickson County,17619,6098,24342,11521,0.723810698,0.250513516,0.473297182
Tennessee,47045 ,Dyer County,11766,3157,15074,8609,0.78054929,0.209433462,0.571115829
Tennessee,47047 ,Fayette County,15661,7000,22928,8661,0.683051291,0.305303559,0.377747732
Tennessee,47049 ,Fentress County,7403,1210,8687,6193,0.852192932,0.139288592,0.71290434
Tennessee,47051 ,Franklin County,13977,4863,19146,9114,0.730021937,0.253995613,0.476026324
Tennessee,47053 ,Gibson County,16245,5764,22336,10481,0.727301218,0.258058739,0.469242479
Tennessee,47055 ,Giles County,9783,3298,13202,6485,0.741024087,0.249810635,0.491213453
Tennessee,47057 ,Grainger County,8559,1463,10123,7096,0.845500346,0.144522375,0.700977971
Tennessee,47059 ,Greene County,22185,5183,28057,17002,0.790711765,0.184731083,0.605980682
Tennessee,47061 ,Grundy County,4795,985,5844,3810,0.820499658,0.168548939,0.651950719
Tennessee,47063 ,Hamblen County,18789,5497,24606,13292,0.763594245,0.223400797,0.540193449
Tennessee,47065 ,Hamilton County,91991,75360,170735,16631,0.538794038,0.441385773,0.097408264
Tennessee,47067 ,Hancock County,2372,362,2744,2010,0.864431487,0.131924198,0.732507289
Tennessee,47069 ,Hardeman County,5760,4180,10058,1580,0.572678465,0.41558958,0.157088884
Tennessee,47071 ,Hardin County,9556,1774,11534,7782,0.828507023,0.153806138,0.674700884
Tennessee,47073 ,Hawkins County,20372,4069,24776,16303,0.822247336,0.164231514,0.658015822
Tennessee,47075 ,Haywood County,3338,4000,7420,-662,0.449865229,0.539083558,-0.089218329
Tennessee,47077 ,Henderson County,9797,2092,12020,7705,0.815058236,0.174043261,0.641014975
Tennessee,47079 ,Henry County,11230,3547,15034,7683,0.746973527,0.235931888,0.511041639
Tennessee,47081 ,Hickman County,7577,2130,9832,5447,0.770646867,0.216639544,0.554007323
Tennessee,47083 ,Houston County,2715,869,3681,1846,0.737571312,0.236077153,0.501494159
Tennessee,47085 ,Humphreys County,6116,2017,8232,4099,0.742954325,0.245019436,0.497934888
Tennessee,47087 ,Jackson County,4106,1133,5308,2973,0.773549359,0.213451394,0.560097965
Tennessee,47089 ,Jefferson County,18609,4645,23562,13964,0.789788643,0.197139462,0.592649181
Tennessee,47091 ,Johnson County,6466,1242,7793,5224,0.829718979,0.159373797,0.670345182
Tennessee,47093 ,Knox County,124339,91097,219869,33242,0.565514011,0.414323984,0.151190027
Tennessee,47095 ,Lake County,1492,526,2034,966,0.73352999,0.258603736,0.474926254
Tennessee,47097 ,Lauderdale County,5672,3193,8963,2479,0.632823831,0.35624233,0.276581502
Tennessee,47099 ,Lawrence County,15334,3195,18718,12139,0.819211454,0.170691313,0.648520141
Tennessee,47101 ,Lewis County,4473,1068,5604,3405,0.798179872,0.190578158,0.607601713
Tennessee,47103 ,Lincoln County,12258,2909,15575,9349,0.787030498,0.186773676,0.600256822
Tennessee,47105 ,Loudon County,21684,6933,29375,14751,0.738178723,0.236017021,0.502161702
Tennessee,47107 ,McMinn County,18175,4357,22815,13818,0.796625027,0.190970853,0.605654175
Tennessee,47109 ,McNairy County,9085,1943,11267,7142,0.806337091,0.172450519,0.633886571
Tennessee,47111 ,Macon County,8095,1307,9486,6788,0.853362851,0.137781995,0.715580856
Tennessee,47113 ,Madison County,23922,18309,42847,5613,0.558312134,0.42731113,0.131001004
Tennessee,47115 ,Marion County,9873,3165,13204,6708,0.747727961,0.239700091,0.50802787
Tennessee,47117 ,Marshall County,11029,3603,14862,7426,0.742093931,0.242430359,0.499663572
Tennessee,47119 ,Maury County,31408,14386,46561,17022,0.674555959,0.308971027,0.365584932
Tennessee,47121 ,Meigs County,4464,1008,5529,3456,0.807379273,0.182311449,0.625067824
Tennessee,47123 ,Monroe County,16742,3760,20749,12982,0.806882259,0.181213552,0.625668707
Tennessee,47125 ,Montgomery County,42156,32426,76678,9730,0.549779598,0.422885313,0.126894285
Tennessee,47127 ,Moore County,2888,573,3539,2315,0.816049732,0.161910144,0.654139587
Tennessee,47129 ,Morgan County,6926,1161,8218,5765,0.842784132,0.141275249,0.701508883
Tennessee,47131 ,Obion County,10790,2589,13521,8201,0.798017898,0.19147992,0.606537978
Tennessee,47133 ,Overton County,7911,2028,10025,5883,0.789127182,0.202294264,0.586832918
Tennessee,47135 ,Perry County,2775,615,3428,2160,0.809509918,0.179404901,0.630105018
Tennessee,47137 ,Pickett County,2373,524,2922,1849,0.81211499,0.179329227,0.632785763
Tennessee,47139 ,Polk County,6792,1492,8360,5300,0.812440191,0.1784689,0.633971292
Tennessee,47141 ,Putnam County,23694,9154,33481,14540,0.707684956,0.273408799,0.434276157
Tennessee,47143 ,Rhea County,11031,2363,13608,8668,0.810626102,0.173647854,0.636978248
Tennessee,47145 ,Roane County,19195,6034,25914,13161,0.740719302,0.23284711,0.507872193
Tennessee,47147 ,Robertson County,24535,8690,33712,15845,0.727782392,0.257771713,0.470010679
Tennessee,47149 ,Rutherford County,81373,59189,143931,22184,0.56536118,0.411231771,0.154129409
Tennessee,47151 ,Scott County,8004,986,9052,7018,0.884224481,0.108926204,0.775298277
Tennessee,47153 ,Sequatchie County,5846,1295,7239,4551,0.807570106,0.178892112,0.628677994
Tennessee,47155 ,Sevier County,33742,8695,43574,25047,0.774360857,0.199545601,0.574815257
Tennessee,47157 ,Shelby County,129543,245208,381858,-115665,0.339243907,0.642144462,-0.302900555
Tennessee,47159 ,Smith County,7124,1798,9035,5326,0.788489209,0.199003874,0.589485335
Tennessee,47161 ,Stewart County,4942,1230,6283,3712,0.786566927,0.195766354,0.590800573
Tennessee,47163 ,Sullivan County,55774,17226,74206,38548,0.751610382,0.232137563,0.519472819
Tennessee,47165 ,Sumner County,63404,27630,92529,35774,0.685233819,0.298609085,0.386624734
Tennessee,47167 ,Tipton County,20063,6832,27291,13231,0.735150782,0.25033894,0.484811843
Tennessee,47169 ,Trousdale County,2930,1011,3991,1919,0.734151842,0.25331997,0.480831872
Tennessee,47171 ,Unicoi County,6593,1610,8294,4983,0.794911985,0.194116229,0.600795756
Tennessee,47173 ,Union County,6777,1248,8096,5529,0.83708004,0.154150198,0.682929842
Tennessee,47175 ,Van Buren County,2338,544,2917,1794,0.801508399,0.186492972,0.615015427
Tennessee,47177 ,Warren County,12323,4126,16692,8197,0.738257848,0.24718428,0.491073568
Tennessee,47179 ,Washington County,40120,18214,59430,21906,0.675079926,0.30647821,0.368601716
Tennessee,47181 ,Wayne County,5795,820,6667,4975,0.86920654,0.12299385,0.746212689
Tennessee,47183 ,Weakley County,10382,3011,13710,7371,0.757257476,0.219620715,0.537636761
Tennessee,47185 ,White County,9587,2134,11867,7453,0.807870565,0.179826409,0.628044156
Tennessee,47187 ,Williamson County,86469,50161,138932,36308,0.622383612,0.361047131,0.261336481
Tennessee,47189 ,Wilson County,50149,22197,74092,27952,0.676847703,0.299587,0.377260703
Texas,48001 ,Anderson County,15110,3955,19221,11155,0.786119349,0.205764528,0.58035482
Texas,48003 ,Andrews County,4943,850,5863,4093,0.843083746,0.144976974,0.698106771
Texas,48005 ,Angelina County,25070,9136,34628,15934,0.723980594,0.263832737,0.460147857
Texas,48007 ,Aransas County,9239,2916,12289,6323,0.751810562,0.237285377,0.514525185
Texas,48009 ,Archer County,4300,446,4796,3854,0.896580484,0.092994162,0.803586322
Texas,48011 ,Armstrong County,1035,75,1112,960,0.930755396,0.067446043,0.863309353
Texas,48013 ,Atascosa County,12039,5876,18116,6163,0.664550673,0.324354162,0.340196511
Texas,48015 ,Austin County,11447,2951,14554,8496,0.78651917,0.202762127,0.583757043
Texas,48017 ,Bailey County,1434,409,1859,1025,0.771382464,0.220010758,0.551371705
Texas,48019 ,Bandera County,10057,2505,12712,7552,0.791142228,0.197057898,0.59408433
Texas,48021 ,Bastrop County,20486,15452,36709,5034,0.55806478,0.420932196,0.137132583
Texas,48023 ,Baylor County,1494,183,1700,1311,0.878823529,0.107647059,0.771176471
Texas,48025 ,Bee County,6006,3288,9414,2718,0.637985978,0.349267049,0.288718929
Texas,48027 ,Bell County,67893,57014,127327,10879,0.533217621,0.447776198,0.085441422
Texas,48029 ,Bexar County,308618,448452,770571,-139834,0.400505599,0.581973627,-0.181468028
Texas,48031 ,Blanco County,5443,1911,7441,3532,0.731487703,0.25682032,0.474667383
Texas,48033 ,Borden County,397,16,416,381,0.954326923,0.038461538,0.915865385
Texas,48035 ,Bosque County,7469,1561,9126,5908,0.818430857,0.171049748,0.647381109
Texas,48037 ,Bowie County,27116,10747,38254,16369,0.708840906,0.280937941,0.427902964
Texas,48039 ,Brazoria County,90433,62228,154938,28205,0.583672179,0.40163162,0.182040558
Texas,48041 ,Brazos County,47530,35349,84943,12181,0.559551699,0.416149653,0.143402046
Texas,48043 ,Brewster County,2461,2258,4822,203,0.510369141,0.468270427,0.042098714
Texas,48045 ,Briscoe County,639,78,725,561,0.88137931,0.107586207,0.773793103
Texas,48047 ,Brooks County,998,1470,2484,-472,0.401771337,0.59178744,-0.190016103
Texas,48049 ,Brown County,13698,2107,15963,11591,0.858109378,0.131992733,0.726116645
Texas,48051 ,Burleson County,6743,1788,8609,4955,0.783250087,0.207689627,0.57556046
Texas,48053 ,Burnet County,18767,5639,24708,13128,0.759551562,0.228225676,0.531325886
Texas,48055 ,Caldwell County,8031,6672,14940,1359,0.537550201,0.446586345,0.090963855
Texas,48057 ,Calhoun County,5641,2148,7856,3493,0.718049898,0.273421589,0.44462831
Texas,48059 ,Callahan County,6012,734,6832,5278,0.879976581,0.107435597,0.772540984
Texas,48061 ,Cameron County,49032,64063,114159,-15031,0.429506215,0.561173451,-0.131667236
Texas,48063 ,Camp County,3626,1394,5058,2232,0.716884144,0.275603005,0.441281139
Texas,48065 ,Carson County,2779,297,3116,2482,0.891848524,0.095314506,0.796534018
Texas,48067 ,Cass County,11033,2795,13924,8238,0.792372881,0.200732548,0.591640333
Texas,48069 ,Castro County,1602,466,2083,1136,0.769083053,0.223715795,0.545367259
Texas,48071 ,Chambers County,17343,3997,21641,13346,0.801395499,0.184695716,0.616699783
Texas,48073 ,Cherokee County,15101,4210,19508,10891,0.77409268,0.215808899,0.558283781
Texas,48075 ,Childress County,1943,310,2279,1633,0.852566915,0.136024572,0.716542343
Texas,48077 ,Clay County,5069,614,5741,4455,0.882947222,0.106950009,0.775997213
Texas,48079 ,Cochran County,809,177,1000,632,0.809,0.177,0.632
Texas,48081 ,Coke County,1565,215,1794,1350,0.872352285,0.119843924,0.752508361
Texas,48083 ,Coleman County,3640,451,4128,3189,0.881782946,0.109253876,0.77252907
Texas,48085 ,Collin County,252318,230945,492216,21373,0.512616412,0.469194419,0.043421994
Texas,48087 ,Collingsworth County,1048,155,1218,893,0.860426929,0.1272578,0.73316913
Texas,48089 ,Colorado County,7440,2403,9912,5037,0.750605327,0.242433414,0.508171913
Texas,48091 ,Comal County,62740,24826,88863,37914,0.706030631,0.279373868,0.426656764
Texas,48093 ,Comanche County,5177,852,6084,4325,0.850920447,0.140039448,0.710880999
Texas,48095 ,Concho County,1058,197,1268,861,0.834384858,0.155362776,0.679022082
Texas,48097 ,Cooke County,15596,3210,18988,12386,0.821360859,0.169054139,0.65230672
Texas,48099 ,Coryell County,15438,7565,23490,7873,0.657215837,0.322051937,0.3351639
Texas,48101 ,Cottle County,543,113,665,430,0.816541353,0.169924812,0.646616541
Texas,48103 ,Crane County,1247,241,1503,1006,0.829673985,0.160345975,0.669328011
Texas,48105 ,Crockett County,1220,344,1574,876,0.775095299,0.218551461,0.556543837
Texas,48107 ,Crosby County,1396,527,1953,869,0.714797747,0.26984127,0.444956477
Texas,48109 ,Culberson County,415,438,864,-23,0.480324074,0.506944444,-0.02662037
Texas,48111 ,Dallam County,1389,197,1609,1192,0.863269111,0.122436296,0.740832815
Texas,48113 ,Dallas County,307076,598576,921638,-291500,0.333185047,0.649469748,-0.316284702
Texas,48115 ,Dawson County,2951,808,3789,2143,0.778833465,0.213248878,0.565584587
Texas,48117 ,Deaf Smith County,3294,1264,4610,2030,0.714533623,0.274186551,0.440347072
Texas,48119 ,Delta County,2162,403,2592,1759,0.834104938,0.155478395,0.678626543
Texas,48121 ,Denton County,222480,188695,417964,33785,0.532294647,0.451462327,0.08083232
Texas,48123 ,DeWitt County,6567,1494,8118,5073,0.808943089,0.184035477,0.624907613
Texas,48125 ,Dickens County,853,130,988,723,0.863360324,0.131578947,0.731781377
Texas,48127 ,Dimmit County,1384,2264,3666,-880,0.377523186,0.61756683,-0.240043644
Texas,48129 ,Donley County,1438,198,1648,1240,0.872572816,0.120145631,0.752427184
Texas,48131 ,Duval County,2443,2575,5053,-132,0.483475163,0.509598258,-0.026123095
Texas,48133 ,Eastland County,7237,983,8292,6254,0.872768934,0.118547998,0.754220936
Texas,48135 ,Ector County,32697,11367,44581,21330,0.733429039,0.254974092,0.478454947
Texas,48137 ,Edwards County,893,168,1066,725,0.837711069,0.157598499,0.68011257
Texas,48139 ,Ellis County,56651,27513,85566,29138,0.662073721,0.321541266,0.340532454
Texas,48141 ,El Paso County,84331,178126,267215,-93795,0.315592313,0.6666018,-0.351009487
Texas,48143 ,Erath County,13684,2916,16853,10768,0.811962262,0.173025574,0.638936688
Texas,48145 ,Falls County,4177,1899,6133,2278,0.681069623,0.309636393,0.37143323
Texas,48147 ,Fannin County,12171,2655,15004,9516,0.811183684,0.176952813,0.634230872
Texas,48149 ,Fayette County,10171,2661,12941,7510,0.785951627,0.205625531,0.580326095
Texas,48151 ,Fisher County,1448,352,1826,1096,0.792990142,0.192771084,0.600219058
Texas,48153 ,Floyd County,1584,438,2039,1146,0.776851398,0.214811182,0.562040216
Texas,48155 ,Foard County,445,99,551,346,0.807622505,0.179673321,0.627949183
Texas,48157 ,Fort Bend County,157595,195191,357833,-37596,0.440414942,0.545480713,-0.105065771
Texas,48159 ,Franklin County,4161,804,5009,3357,0.830704731,0.16051108,0.670193651
Texas,48161 ,Freestone County,6991,1635,8711,5356,0.802548502,0.187693721,0.614854781
Texas,48163 ,Frio County,2823,2422,5279,401,0.534760371,0.458799015,0.075961356
Texas,48165 ,Gaines County,5355,576,5995,4779,0.89324437,0.096080067,0.797164304
Texas,48167 ,Galveston County,93911,58842,155060,35069,0.605642977,0.379478911,0.226164066
Texas,48169 ,Garza County,1413,231,1653,1182,0.854809437,0.139745917,0.715063521
Texas,48171 ,Gillespie County,12514,3176,15846,9338,0.789726114,0.20042913,0.589296983
Texas,48173 ,Glasscock County,611,39,653,572,0.93568147,0.059724349,0.875957121
Texas,48175 ,Goliad County,3085,877,3988,2208,0.773570712,0.219909729,0.553660983
Texas,48177 ,Gonzales County,5627,1948,7647,3679,0.735844122,0.254740421,0.481103701
Texas,48179 ,Gray County,6840,829,7782,6011,0.878951426,0.106527885,0.772423542
Texas,48181 ,Grayson County,44163,14506,59439,29657,0.742997022,0.24404852,0.498948502
Texas,48183 ,Gregg County,32493,14796,47982,17697,0.677191447,0.308365637,0.36882581
Texas,48185 ,Grimes County,9432,2833,12413,6599,0.759848546,0.22822847,0.531620076
Texas,48187 ,Guadalupe County,47553,28805,77592,18748,0.612859573,0.371236725,0.241622848
Texas,48189 ,Hale County,7177,2279,9584,4898,0.748852254,0.237792154,0.5110601
Texas,48191 ,Hall County,995,168,1168,827,0.851883562,0.143835616,0.708047945
Texas,48193 ,Hamilton County,3616,641,4349,2975,0.831455507,0.147390205,0.684065302
Texas,48195 ,Hansford County,1848,166,2046,1682,0.903225806,0.08113392,0.822091887
Texas,48197 ,Hardeman County,1330,241,1580,1089,0.841772152,0.152531646,0.689240506
Texas,48199 ,Hardin County,23858,3474,27635,20384,0.863325493,0.12571015,0.737615343
Texas,48201 ,Harris County,700630,918193,1640818,-217563,0.427000435,0.559594666,-0.13259423
Texas,48203 ,Harrison County,21466,7908,29710,13558,0.722517671,0.266173006,0.456344665
Texas,48205 ,Hartley County,1868,195,2078,1673,0.89894129,0.093840231,0.805101059
Texas,48207 ,Haskell County,1840,353,2214,1487,0.831074977,0.159439928,0.67163505
Texas,48209 ,Hays County,47680,59524,109357,-11844,0.436003182,0.544309006,-0.108305824
Texas,48211 ,Hemphill County,1486,206,1720,1280,0.863953488,0.119767442,0.744186047
Texas,48213 ,Henderson County,28911,7060,36310,21851,0.796226935,0.194436794,0.60179014
Texas,48215 ,Hidalgo County,90527,128199,220884,-37672,0.409839554,0.580390612,-0.170551058
Texas,48217 ,Hill County,11926,2860,14931,9066,0.798740875,0.191547786,0.607193088
Texas,48219 ,Hockley County,6536,1482,8095,5054,0.807411983,0.183075973,0.62433601
Texas,48221 ,Hood County,26487,5641,32580,20846,0.812983425,0.173143033,0.639840393
Texas,48223 ,Hopkins County,12719,3046,15939,9673,0.797979798,0.191103582,0.606876216
Texas,48225 ,Houston County,7060,2314,9437,4746,0.748119106,0.245205044,0.502914062
Texas,48227 ,Howard County,8054,2069,10240,5985,0.786523438,0.202050781,0.584472656
Texas,48229 ,Hudspeth County,779,371,1165,408,0.668669528,0.318454936,0.350214592
Texas,48231 ,Hunt County,29163,8906,38574,20257,0.756027376,0.230880904,0.525146472
Texas,48233 ,Hutchinson County,7681,965,8771,6716,0.875726827,0.110021662,0.765705165
Texas,48235 ,Irion County,759,120,889,639,0.853768279,0.134983127,0.718785152
Texas,48237 ,Jack County,3418,331,3782,3087,0.903754627,0.087519831,0.816234796
Texas,48239 ,Jackson County,5231,1033,6340,4198,0.825078864,0.162933754,0.66214511
Texas,48241 ,Jasper County,12542,2954,15608,9588,0.803562276,0.189261917,0.614300359
Texas,48243 ,Jeff Davis County,784,501,1305,283,0.600766284,0.383908046,0.216858238
Texas,48245 ,Jefferson County,47570,46073,94739,1497,0.502116341,0.486315034,0.015801307
Texas,48247 ,Jim Hogg County,833,1197,2036,-364,0.40913556,0.587917485,-0.178781925
Texas,48249 ,Jim Wells County,7453,6119,13669,1334,0.545248372,0.447655278,0.097593094
Texas,48251 ,Johnson County,54628,16464,72005,38164,0.758669537,0.228650788,0.530018749
Texas,48253 ,Jones County,5660,999,6741,4661,0.839638036,0.148197597,0.691440439
Texas,48255 ,Karnes County,3968,1234,5249,2734,0.755953515,0.235092399,0.520861116
Texas,48257 ,Kaufman County,37624,18405,56703,19219,0.663527503,0.324586001,0.338941502
Texas,48259 ,Kendall County,20083,6020,26438,14063,0.759626295,0.227702549,0.531923746
Texas,48261 ,Kenedy County,127,65,194,62,0.654639175,0.335051546,0.319587629
Texas,48263 ,Kent County,411,47,462,364,0.88961039,0.101731602,0.787878788
Texas,48265 ,Kerr County,20858,6510,27738,14348,0.751964814,0.234696085,0.517268729
Texas,48267 ,Kimble County,1987,284,2292,1703,0.866928447,0.12390925,0.743019197
Texas,48269 ,King County,151,8,159,143,0.949685535,0.050314465,0.899371069
Texas,48271 ,Kinney County,1144,446,1603,698,0.713661884,0.278228322,0.435433562
Texas,48273 ,Kleberg County,5557,5359,11041,198,0.50330586,0.485372702,0.017933158
Texas,48275 ,Knox County,1180,265,1456,915,0.81043956,0.182005495,0.628434066
Texas,48277 ,Lamar County,16760,4458,21418,12302,0.782519376,0.208142684,0.574376693
Texas,48279 ,Lamb County,3521,840,4408,2681,0.798774955,0.190562613,0.608212341
Texas,48281 ,Lampasas County,8086,2144,10399,5942,0.777574767,0.206173671,0.571401096
Texas,48283 ,La Salle County,1335,1052,2406,283,0.554862843,0.437240233,0.11762261
Texas,48285 ,Lavaca County,8802,1333,10195,7469,0.863364394,0.130750368,0.732614026
Texas,48287 ,Lee County,6255,1750,8086,4505,0.773559238,0.216423448,0.55713579
Texas,48289 ,Leon County,7522,1072,8672,6450,0.867389299,0.123616236,0.743773063
Texas,48291 ,Liberty County,23302,5785,29334,17517,0.79436831,0.197211427,0.597156883
Texas,48293 ,Limestone County,6789,2213,9095,4576,0.746454096,0.243320506,0.50313359
Texas,48295 ,Lipscomb County,1205,131,1353,1074,0.890613452,0.096821877,0.793791574
Texas,48297 ,Live Oak County,4199,819,5054,3380,0.830827068,0.162049861,0.668777206
Texas,48299 ,Llano County,9996,3167,13278,6829,0.752824221,0.238514837,0.514309384
Texas,48301 ,Loving County,60,4,66,56,0.909090909,0.060606061,0.848484848
Texas,48303 ,Lubbock County,78861,40017,120771,38844,0.652979606,0.331346101,0.321633505
Texas,48305 ,Lynn County,1853,428,2293,1425,0.808111644,0.186655037,0.621456607
Texas,48307 ,McCulloch County,2904,490,3436,2414,0.845168801,0.142607683,0.702561118
Texas,48309 ,McLennan County,59543,36688,97771,22855,0.609004715,0.375244193,0.233760522
Texas,48311 ,McMullen County,460,53,516,407,0.891472868,0.102713178,0.78875969
Texas,48313 ,Madison County,4169,1088,5297,3081,0.787049273,0.205399283,0.581649991
Texas,48315 ,Marion County,3470,1339,4864,2131,0.713404605,0.275287829,0.438116776
Texas,48317 ,Martin County,1857,288,2160,1569,0.859722222,0.133333333,0.726388889
Texas,48319 ,Mason County,2108,566,2700,1542,0.780740741,0.20962963,0.571111111
Texas,48321 ,Matagorda County,9845,3733,13726,6112,0.717251931,0.271965613,0.445286318
Texas,48323 ,Maverick County,6881,8332,15346,-1451,0.44839046,0.542942786,-0.094552326
Texas,48325 ,Medina County,15642,6773,22644,8869,0.690779014,0.299107931,0.391671083
Texas,48327 ,Menard County,823,197,1028,626,0.800583658,0.191634241,0.608949416
Texas,48329 ,Midland County,45624,12329,58856,33295,0.775180101,0.209477368,0.565702732
Texas,48331 ,Milam County,7984,2496,10576,5488,0.754916793,0.236006051,0.518910741
Texas,48333 ,Mills County,2217,271,2505,1946,0.88502994,0.108183633,0.776846307
Texas,48335 ,Mitchell County,2170,397,2579,1773,0.8414114,0.153935634,0.687475766
Texas,48337 ,Montague County,8615,1097,9814,7518,0.877827593,0.111779091,0.766048502
Texas,48339 ,Montgomery County,193382,74377,271451,119005,0.712401133,0.273997885,0.438403248
Texas,48341 ,Moore County,4359,1062,5508,3297,0.791394336,0.192810458,0.598583878
Texas,48343 ,Morris County,3872,1669,5587,2203,0.693037408,0.298729193,0.394308216
Texas,48345 ,Motley County,604,46,652,558,0.926380368,0.070552147,0.855828221
Texas,48347 ,Nacogdoches County,17378,9000,26763,8378,0.649329298,0.33628517,0.313044128
Texas,48349 ,Navarro County,13800,5101,19121,8699,0.721719575,0.26677475,0.454944825
Texas,48351 ,Newton County,4882,1175,6096,3707,0.800853018,0.192749344,0.608103675
Texas,48353 ,Nolan County,4131,1162,5356,2969,0.771284541,0.21695295,0.554331591
Texas,48355 ,Nueces County,64617,60925,127314,3692,0.507540412,0.478541244,0.028999167
Texas,48357 ,Ochiltree County,2811,302,3155,2509,0.890966719,0.095721078,0.795245642
Texas,48359 ,Oldham County,917,81,1009,836,0.908820614,0.080277502,0.828543112
Texas,48361 ,Orange County,29170,6354,35974,22816,0.810863401,0.176627564,0.634235837
Texas,48363 ,Palo Pinto County,10179,2178,12485,8001,0.815298358,0.174449339,0.640849019
Texas,48365 ,Panola County,9322,2057,11452,7265,0.814006287,0.17961928,0.634387007
Texas,48367 ,Parker County,62045,13017,76128,49028,0.815008932,0.170988335,0.644020597
Texas,48369 ,Parmer County,2135,488,2650,1647,0.805660377,0.184150943,0.621509434
Texas,48371 ,Pecos County,3215,1382,4668,1833,0.688731791,0.296058269,0.392673522
Texas,48373 ,Polk County,18573,5387,24181,13186,0.768082379,0.222778214,0.545304164
Texas,48375 ,Potter County,22820,9921,33321,12899,0.684853396,0.297740164,0.387113232
Texas,48377 ,Presidio County,721,1463,2217,-742,0.325214253,0.659900767,-0.334686513
Texas,48379 ,Rains County,5155,842,6053,4313,0.851643813,0.139104576,0.712539237
Texas,48381 ,Randall County,50597,12750,64412,37847,0.785521331,0.197944482,0.587576849
Texas,48383 ,Reagan County,942,172,1124,770,0.838078292,0.153024911,0.685053381
Texas,48385 ,Real County,1643,320,1982,1323,0.828960646,0.161453078,0.667507568
Texas,48387 ,Red River County,4517,1246,5806,3271,0.777988288,0.21460558,0.563382708
Texas,48389 ,Reeves County,2254,1395,3687,859,0.61133713,0.378356387,0.232980743
Texas,48391 ,Refugio County,2210,1108,3366,1102,0.656565657,0.329174094,0.327391563
Texas,48393 ,Roberts County,529,17,550,512,0.961818182,0.030909091,0.930909091
Texas,48395 ,Robertson County,5646,2374,8099,3272,0.697123102,0.293122608,0.404000494
Texas,48397 ,Rockwall County,38842,18149,57792,20693,0.672099945,0.314040006,0.358059939
Texas,48399 ,Runnels County,3807,552,4409,3255,0.863461102,0.125198458,0.738262645
Texas,48401 ,Rusk County,16534,4629,21368,11905,0.773773867,0.216632347,0.55714152
Texas,48403 ,Sabine County,4784,669,5487,4115,0.871878987,0.121924549,0.749954438
Texas,48405 ,San Augustine County,3007,980,4002,2027,0.751374313,0.244877561,0.506496752
Texas,48407 ,San Jacinto County,10161,2337,12638,7824,0.804003798,0.1849185,0.619085298
Texas,48409 ,San Patricio County,16516,8988,25888,7528,0.637978986,0.347187886,0.2907911
Texas,48411 ,San Saba County,2308,287,2602,2021,0.887009992,0.110299769,0.776710223
Texas,48413 ,Schleicher County,940,211,1159,729,0.811044003,0.182053494,0.628990509
Texas,48415 ,Scurry County,4983,818,5869,4165,0.849037315,0.139376384,0.70966093
Texas,48417 ,Shackelford County,1484,130,1628,1354,0.911547912,0.07985258,0.831695332
Texas,48419 ,Shelby County,7975,2068,10084,5907,0.790856803,0.20507735,0.585779453
Texas,48421 ,Sherman County,886,91,991,795,0.894046418,0.091826438,0.80221998
Texas,48423 ,Smith County,69080,29615,100075,39465,0.690282288,0.295928054,0.394354234
Texas,48425 ,Somervell County,4099,768,4940,3331,0.829757085,0.155465587,0.674291498
Texas,48427 ,Starr County,8247,9123,17525,-876,0.470584879,0.520570613,-0.049985735
Texas,48429 ,Stephens County,3385,397,3800,2988,0.890789474,0.104473684,0.786315789
Texas,48431 ,Sterling County,584,51,639,533,0.913928013,0.079812207,0.834115806
Texas,48433 ,Stonewall County,615,116,736,499,0.835597826,0.157608696,0.67798913
Texas,48435 ,Sutton County,1222,322,1557,900,0.784842646,0.206807964,0.578034682
Texas,48437 ,Swisher County,1845,478,2355,1367,0.78343949,0.202972399,0.580467091
Texas,48439 ,Tarrant County,409741,411567,834697,-1826,0.490885914,0.493073534,-0.00218762
Texas,48441 ,Taylor County,39547,14588,55112,24959,0.71757512,0.264697344,0.452877776
Texas,48443 ,Terrell County,334,119,458,215,0.729257642,0.259825328,0.469432314
Texas,48445 ,Terry County,2812,757,3612,2055,0.778516058,0.209579181,0.568936877
Texas,48447 ,Throckmorton County,806,82,899,724,0.896551724,0.091212458,0.805339266
Texas,48449 ,Titus County,7570,2856,10539,4714,0.718284467,0.270993453,0.447291014
Texas,48451 ,Tom Green County,32129,12106,44891,20023,0.71571139,0.269675436,0.446035954
Texas,48453 ,Travis County,161337,435860,610349,-274523,0.264335651,0.714116022,-0.449780372
Texas,48455 ,Trinity County,5579,1323,6938,4256,0.804122225,0.190688959,0.613433266
Texas,48457 ,Tyler County,8194,1403,9660,6791,0.848240166,0.145238095,0.70300207
Texas,48459 ,Upshur County,15809,2877,18887,12932,0.837030762,0.152326997,0.684703764
Texas,48461 ,Upton County,1178,170,1368,1008,0.861111111,0.124269006,0.736842105
Texas,48463 ,Uvalde County,6174,4073,10342,2101,0.596983175,0.39383098,0.203152195
Texas,48465 ,Val Verde County,8284,6771,15272,1513,0.542430592,0.443360398,0.099070194
Texas,48467 ,Van Zandt County,22270,3516,25994,18754,0.85673617,0.135261984,0.721474186
Texas,48469 ,Victoria County,23347,10371,34205,12976,0.682561029,0.303201286,0.379359743
Texas,48471 ,Walker County,15368,7875,23641,7493,0.650057104,0.333107737,0.316949368
Texas,48473 ,Waller County,14260,8191,22734,6069,0.627254333,0.360297352,0.266956981
Texas,48475 ,Ward County,3241,764,4060,2477,0.798275862,0.18817734,0.610098522
Texas,48477 ,Washington County,12959,4261,17418,8698,0.744000459,0.24463199,0.499368469
Texas,48479 ,Webb County,25898,41820,68397,-15922,0.378642338,0.611430326,-0.232787988
Texas,48481 ,Wharton County,11926,4694,16761,7232,0.711532725,0.280054889,0.431477835
Texas,48483 ,Wheeler County,2159,168,2337,1991,0.923833975,0.071887035,0.851946941
Texas,48485 ,Wichita County,32069,13161,46030,18908,0.696697806,0.285922225,0.410775581
Texas,48487 ,Wilbarger County,3524,956,4524,2568,0.778956676,0.211317418,0.567639257
Texas,48489 ,Willacy County,2437,3097,5575,-660,0.437130045,0.555515695,-0.11838565
Texas,48491 ,Williamson County,139729,143795,289312,-4066,0.482969942,0.497023974,-0.014054032
Texas,48493 ,Wilson County,18457,6350,25006,12107,0.738102855,0.253939055,0.484163801
Texas,48495 ,Winkler County,1753,358,2126,1395,0.824553151,0.168391345,0.656161806
Texas,48497 ,Wise County,27032,4973,32362,22059,0.835300661,0.153667882,0.681632779
Texas,48499 ,Wood County,19049,3509,22779,15540,0.836252689,0.154045393,0.682207296
Texas,48501 ,Yoakum County,2172,419,2633,1753,0.824914546,0.159134068,0.665780479
Texas,48503 ,Young County,7112,1036,8242,6076,0.862897355,0.125697646,0.737199709
Texas,48505 ,Zapata County,2033,1826,3874,207,0.524780589,0.471347445,0.053433144
Texas,48507 ,Zavala County,1490,2864,4379,-1374,0.340260333,0.654030601,-0.313770267
Utah,49001 ,Beaver County,2695,357,3100,2338,0.869354839,0.11516129,0.754193548
Utah,49003 ,Box Elder County,21548,4473,27027,17075,0.797276797,0.165501166,0.631775632
Utah,49005 ,Cache County,38032,16650,57571,21382,0.660610377,0.289208108,0.371402269
Utah,49007 ,Carbon County,6693,2392,9369,4301,0.714377201,0.255310065,0.459067136
Utah,49009 ,Daggett County,496,111,619,385,0.801292407,0.179321486,0.621970921
Utah,49011 ,Davis County,104135,57411,169895,46724,0.612937403,0.33792048,0.275016922
Utah,49013 ,Duchesne County,7513,843,8524,6670,0.881393712,0.098897231,0.782496481
Utah,49015 ,Emery County,4207,572,4865,3635,0.864748201,0.117574512,0.74717369
Utah,49017 ,Garfield County,2158,514,2732,1644,0.789897511,0.188140556,0.601756955
Utah,49019 ,Grand County,2248,2806,5185,-558,0.433558341,0.541176471,-0.107618129
Utah,49021 ,Iron County,18989,4892,24890,14097,0.762916834,0.196544797,0.566372037
Utah,49023 ,Juab County,5087,645,5866,4442,0.867200818,0.109955677,0.757245141
Utah,49025 ,Kane County,2998,1083,4180,1915,0.71722488,0.259090909,0.458133971
Utah,49027 ,Millard County,5404,624,6160,4780,0.877272727,0.101298701,0.775974026
Utah,49029 ,Morgan County,5181,1086,6512,4095,0.795608108,0.166769042,0.628839066
Utah,49031 ,Piute County,773,86,871,687,0.887485649,0.098737084,0.788748565
Utah,49033 ,Rich County,1157,180,1363,977,0.848862803,0.132061629,0.716801174
Utah,49035 ,Salt Lake County,230174,289906,541175,-59732,0.425322678,0.535697325,-0.110374648
Utah,49037 ,San Juan County,3535,3113,6878,422,0.513957546,0.452602501,0.061355045
Utah,49039 ,Sanpete County,10459,1794,12631,8665,0.828042119,0.14203151,0.686010609
Utah,49041 ,Sevier County,9052,1084,10363,7968,0.873492232,0.104602914,0.768889318
Utah,49043 ,Summit County,10252,15244,26088,-4992,0.392977614,0.58432996,-0.191352346
Utah,49045 ,Tooele County,21014,8943,31518,12071,0.666730122,0.283742623,0.382987499
Utah,49047 ,Uintah County,13261,1663,15307,11598,0.866335663,0.108643104,0.757692559
Utah,49049 ,Utah County,192812,76033,284480,116779,0.677769966,0.267270107,0.410499859
Utah,49051 ,Wasatch County,10795,6187,17581,4608,0.61401513,0.351913998,0.262101132
Utah,49053 ,Washington County,67294,20530,90476,46764,0.743777355,0.226911004,0.516866351
Utah,49055 ,Wayne County,1229,365,1621,864,0.758173967,0.225169648,0.533004318
Utah,49057 ,Weber County,65949,40695,111442,25254,0.591778683,0.365167531,0.226611152
Vermont,50001 ,Addison County,6292,14967,22022,-8675,0.285714286,0.679638543,-0.393924258
Vermont,50003 ,Bennington County,7114,12705,20462,-5591,0.34766885,0.620907047,-0.273238198
Vermont,50005 ,Caledonia County,6551,9011,16169,-2460,0.405158018,0.557301008,-0.15214299
Vermont,50007 ,Chittenden County,21017,74961,98915,-53944,0.212475358,0.757832482,-0.545357125
Vermont,50009 ,Essex County,1773,1405,3288,368,0.539233577,0.427311436,0.111922141
Vermont,50011 ,Franklin County,11274,13611,25830,-2337,0.436469222,0.526945412,-0.09047619
Vermont,50013 ,Grand Isle County,1810,2905,4851,-1095,0.373118945,0.598845599,-0.225726654
Vermont,50015 ,Lamoille County,4163,10240,14915,-6077,0.279114985,0.686557157,-0.407442172
Vermont,50017 ,Orange County,6187,10304,17122,-4117,0.361347973,0.601798855,-0.240450882
Vermont,50019 ,Orleans County,6512,7147,14096,-635,0.461975028,0.507023269,-0.045048241
Vermont,50021 ,Rutland County,14672,18230,33970,-3558,0.431910509,0.536649985,-0.104739476
Vermont,50023 ,Washington County,8928,25191,35307,-16263,0.252867703,0.713484578,-0.460616875
Vermont,50025 ,Windham County,6440,18767,26035,-12327,0.247359324,0.720837334,-0.47347801
Vermont,50027 ,Windsor County,9971,23376,34446,-13405,0.289467572,0.678627417,-0.389159844
Virginia,51001 ,Accomack County,9172,7578,16962,1594,0.540738121,0.446763353,0.093974767
Virginia,51003 ,Albemarle County,20804,42466,64657,-21662,0.321759438,0.656788901,-0.335029463
Virginia,51005 ,Alleghany County,5859,2243,8203,3616,0.714250884,0.273436548,0.440814336
Virginia,51007 ,Amelia County,5390,2411,7893,2979,0.682883568,0.305460535,0.377423033
Virginia,51009 ,Amherst County,11041,5672,17005,5369,0.649279624,0.333548956,0.315730667
Virginia,51011 ,Appomattox County,6702,2418,9268,4284,0.723133362,0.260897713,0.46223565
Virginia,51013 ,Arlington County,22318,105344,130699,-83026,0.170758766,0.806004637,-0.63524587
Virginia,51015 ,Augusta County,30714,10840,42278,19874,0.726477128,0.256398127,0.470079001
Virginia,51017 ,Bath County,1834,646,2501,1188,0.733306677,0.258296681,0.475009996
Virginia,51019 ,Bedford County,35600,12176,48669,23424,0.731471779,0.250179786,0.481291993
Virginia,51021 ,Bland County,2903,532,3479,2371,0.834435183,0.152917505,0.681517677
Virginia,51023 ,Botetourt County,15099,5700,21120,9399,0.714914773,0.269886364,0.445028409
Virginia,51025 ,Brunswick County,3357,4552,7948,-1195,0.422370408,0.572722698,-0.15035229
Virginia,51027 ,Buchanan County,8311,1587,9953,6724,0.835024616,0.159449412,0.675575203
Virginia,51029 ,Buckingham County,4544,3471,8126,1073,0.559192715,0.427147428,0.132045287
Virginia,51031 ,Campbell County,21245,8070,29892,13175,0.710725278,0.269971899,0.440753379
Virginia,51033 ,Caroline County,8336,7657,16288,679,0.511787819,0.470100688,0.041687132
Virginia,51035 ,Carroll County,12659,2842,15651,9817,0.808830107,0.181585841,0.627244266
Virginia,51036 ,Charles City County,1761,2624,4441,-863,0.396532313,0.590857915,-0.194325602
Virginia,51037 ,Charlotte County,3815,2317,6191,1498,0.616217089,0.374252948,0.241964141
Virginia,51041 ,Chesterfield County,93326,106935,203884,-13609,0.457740676,0.524489416,-0.066748739
Virginia,51043 ,Clarke County,5192,3920,9337,1272,0.556067259,0.419835065,0.136232194
Virginia,51045 ,Craig County,2536,587,3169,1949,0.800252446,0.185231934,0.615020511
Virginia,51047 ,Culpeper County,16012,10617,27116,5395,0.590500074,0.39154005,0.198960024
Virginia,51049 ,Cumberland County,3019,2227,5310,792,0.568549906,0.419397363,0.149152542
Virginia,51051 ,Dickenson County,5748,1503,7303,4245,0.787073805,0.205805833,0.581267972
Virginia,51053 ,Dinwiddie County,8695,6224,15092,2471,0.576133051,0.412403923,0.163729128
Virginia,51057 ,Essex County,3075,3038,6178,37,0.497733894,0.491744901,0.005988993
Virginia,51059 ,Fairfax County,168401,419943,600823,-251542,0.280283877,0.698946279,-0.418662401
Virginia,51061 ,Fauquier County,25106,17565,43661,7541,0.575021186,0.402304116,0.17271707
Virginia,51063 ,Floyd County,6225,3004,9408,3221,0.661670918,0.319302721,0.342368197
Virginia,51065 ,Fluvanna County,8155,7414,15840,741,0.514835859,0.468055556,0.046780303
Virginia,51067 ,Franklin County,20895,8381,29702,12514,0.703487981,0.282169551,0.42131843
Virginia,51069 ,Frederick County,30558,17207,48703,13351,0.627435682,0.353304725,0.274130957
Virginia,51071 ,Giles County,6876,2156,9176,4720,0.74934612,0.234960767,0.514385353
Virginia,51073 ,Gloucester County,14875,6964,22282,7911,0.667579212,0.312539269,0.355039943
Virginia,51075 ,Goochland County,9966,6685,16950,3281,0.587964602,0.39439528,0.193569322
Virginia,51077 ,Grayson County,6529,1535,8131,4994,0.802976264,0.188783667,0.614192596
Virginia,51079 ,Greene County,6866,4163,11311,2703,0.607019715,0.368048802,0.238970913
Virginia,51081 ,Greensville County,1914,2627,4574,-713,0.418452121,0.574333188,-0.155881067
Virginia,51083 ,Halifax County,10418,7666,18248,2752,0.570911881,0.420100833,0.150811048
Virginia,51085 ,Hanover County,44318,25307,70967,19011,0.624487438,0.356602364,0.267885073
Virginia,51087 ,Henrico County,63440,116572,183152,-53132,0.346378964,0.636476806,-0.290097842
Virginia,51089 ,Henry County,16725,9127,26105,7598,0.640681862,0.349626508,0.291055353
Virginia,51091 ,Highland County,1092,417,1533,675,0.712328767,0.272015656,0.440313112
Virginia,51093 ,Isle of Wight County,13707,9399,23456,4308,0.584370737,0.400707708,0.183663029
Virginia,51095 ,James City County,23153,25553,49622,-2400,0.466587401,0.514953045,-0.048365644
Virginia,51097 ,King and Queen County,2450,1590,4115,860,0.595382746,0.386391252,0.208991495
Virginia,51099 ,King George County,8446,5404,14224,3042,0.593785152,0.37992126,0.213863892
Virginia,51101 ,King William County,7320,3260,10736,4060,0.681818182,0.303651267,0.378166915
Virginia,51103 ,Lancaster County,3697,3368,7152,329,0.516918345,0.470917226,0.046001119
Virginia,51105 ,Lee County,8365,1489,9946,6876,0.841041625,0.149708425,0.691333199
Virginia,51107 ,Loudoun County,82088,138372,224862,-56284,0.365059459,0.61536409,-0.250304631
Virginia,51109 ,Louisa County,13294,8269,21915,5025,0.606616473,0.377321469,0.229295003
Virginia,51111 ,Lunenburg County,3537,2418,6000,1119,0.5895,0.403,0.1865
Virginia,51113 ,Madison County,5300,2698,8129,2602,0.651986714,0.331898142,0.320088572
Virginia,51115 ,Mathews County,3901,1825,5826,2076,0.669584621,0.313250944,0.356333677
Virginia,51117 ,Mecklenburg County,9266,6803,16204,2463,0.571834115,0.419834609,0.151999506
Virginia,51119 ,Middlesex County,4196,2491,6785,1705,0.618422992,0.367133382,0.251289609
Virginia,51121 ,Montgomery County,20629,23218,45037,-2589,0.458045607,0.515531674,-0.057486067
Virginia,51125 ,Nelson County,4812,4327,9316,485,0.5165307,0.464469729,0.05206097
Virginia,51127 ,New Kent County,9631,4621,14463,5010,0.665906105,0.319504944,0.346401162
Virginia,51131 ,Northampton County,2955,3667,6732,-712,0.438948307,0.544711824,-0.105763518
Virginia,51133 ,Northumberland County,4485,3252,7815,1233,0.573896353,0.416122841,0.157773512
Virginia,51135 ,Nottoway County,4027,2971,7078,1056,0.56894603,0.419751342,0.149194688
Virginia,51137 ,Orange County,12426,7995,20742,4431,0.599074342,0.385449812,0.21362453
Virginia,51139 ,Page County,9345,3007,12514,6338,0.746763625,0.240290874,0.506472751
Virginia,51141 ,Patrick County,7485,1954,9534,5531,0.785084959,0.204950703,0.580134256
Virginia,51143 ,Pittsylvania County,23751,10115,34227,13636,0.693925848,0.295526923,0.398398925
Virginia,51145 ,Powhatan County,14055,5320,19730,8735,0.712366954,0.269640142,0.442726812
Virginia,51147 ,Prince Edward County,4434,4973,9574,-539,0.463129309,0.519427616,-0.056298308
Virginia,51149 ,Prince George County,10103,7103,17432,3000,0.579566315,0.407469022,0.172097292
Virginia,51153 ,Prince William County,81222,142863,228056,-61641,0.356149367,0.626438243,-0.270288876
Virginia,51155 ,Pulaski County,12127,4925,17376,7202,0.697916667,0.283436924,0.414479742
Virginia,51157 ,Rappahannock County,2812,2096,4978,716,0.564885496,0.421052632,0.143832865
Virginia,51159 ,Richmond County,2547,1513,4102,1034,0.620916626,0.368844466,0.25207216
Virginia,51161 ,Roanoke County,34268,21801,57184,12467,0.599258534,0.381243005,0.218015529
Virginia,51163 ,Rockbridge County,8088,4086,12373,4002,0.653681403,0.33023519,0.323446214
Virginia,51165 ,Rockingham County,30349,12644,43811,17705,0.692725571,0.288603319,0.404122252
Virginia,51167 ,Russell County,10879,2373,13386,8506,0.812714777,0.177274765,0.635440012
Virginia,51169 ,Scott County,9063,1692,10869,7371,0.83383936,0.155672095,0.678167265
Virginia,51171 ,Shenandoah County,16463,6836,23684,9627,0.695110623,0.288633677,0.406476946
Virginia,51173 ,Smyth County,10963,3008,14136,7955,0.775537634,0.21279004,0.562747595
Virginia,51175 ,Southampton County,5730,3969,9786,1761,0.585530349,0.405579399,0.17995095
Virginia,51177 ,Spotsylvania County,39411,34307,75317,5104,0.523268319,0.455501414,0.067766905
Virginia,51179 ,Stafford County,37636,40245,79625,-2609,0.47266562,0.505431711,-0.032766091
Virginia,51181 ,Surry County,2025,2397,4471,-372,0.45291881,0.536121673,-0.083202863
Virginia,51183 ,Sussex County,2219,2827,5088,-608,0.436124214,0.555621069,-0.119496855
Virginia,51185 ,Tazewell County,16731,3205,20134,13526,0.830982418,0.159183471,0.671798947
Virginia,51187 ,Warren County,14069,6603,21147,7466,0.665295314,0.312242871,0.353052442
Virginia,51191 ,Washington County,21679,6617,28685,15062,0.755760851,0.230678055,0.525082796
Virginia,51193 ,Westmoreland County,5318,4501,9933,817,0.535387094,0.453136011,0.082251082
Virginia,51195 ,Wise County,13366,3110,16615,10256,0.804453807,0.187180259,0.617273548
Virginia,51197 ,Wythe County,11733,3143,15072,8590,0.778463376,0.208532378,0.569930998
Virginia,51199 ,York County,20241,17683,38787,2558,0.521850104,0.455900173,0.065949932
Virginia,51510 ,Alexandria city,14544,66240,82508,-51696,0.176273816,0.802831241,-0.626557425
Virginia,51520 ,Bristol city,5347,2313,7806,3034,0.684985908,0.29631053,0.388675378
Virginia,51530 ,Buena Vista city,1863,825,2776,1038,0.67110951,0.297190202,0.373919308
Virginia,51540 ,Charlottesville city,3094,20696,24205,-17602,0.12782483,0.855029952,-0.727205123
Virginia,51550 ,Chesapeake city,58180,66377,127108,-8197,0.457720993,0.52220946,-0.064488467
Virginia,51570 ,Colonial Heights city,6007,2972,9146,3035,0.656789853,0.324950798,0.331839055
Virginia,51580 ,Covington city,1580,964,2603,616,0.606991932,0.370341913,0.236650019
Virginia,51590 ,Danville city,7428,11710,19389,-4282,0.383103822,0.603950694,-0.220846872
Virginia,51595 ,Emporia city,754,1612,2381,-858,0.316673667,0.677026459,-0.360352793
Virginia,51600 ,Fairfax city,4007,9174,13483,-5167,0.297189053,0.680412371,-0.383223318
Virginia,51610 ,Falls Church city,1490,7146,8819,-5656,0.168953396,0.810295952,-0.641342556
Virginia,51620 ,Franklin city,1487,2525,4058,-1038,0.366436668,0.622227698,-0.25579103
Virginia,51630 ,Fredericksburg city,4037,8517,12862,-4480,0.313870316,0.662183175,-0.34831286
Virginia,51640 ,Galax city,1838,777,2638,1061,0.696739955,0.294541319,0.402198635
Virginia,51650 ,Hampton city,18430,46220,65901,-27790,0.279661917,0.701355063,-0.421693146
Virginia,51660 ,Harrisonburg city,5591,11022,17086,-5431,0.327226969,0.645089547,-0.317862578
Virginia,51670 ,Hopewell city,4020,5430,9608,-1410,0.418401332,0.565154038,-0.146752706
Virginia,51678 ,Lexington city,906,1791,2762,-885,0.328023172,0.648443157,-0.320419986
Virginia,51680 ,Lynchburg city,17097,18048,36363,-951,0.470175728,0.496328686,-0.026152958
Virginia,51683 ,Manassas city,6256,10356,16968,-4100,0.368694012,0.610325318,-0.241631306
Virginia,51685 ,Manassas Park city,1979,3992,6087,-2013,0.325119106,0.655823887,-0.330704781
Virginia,51690 ,Martinsville city,2165,3766,6013,-1601,0.360053218,0.626309662,-0.266256444
Virginia,51700 ,Newport News city,26377,53099,81203,-26722,0.3248279,0.653904412,-0.329076512
Virginia,51710 ,Norfolk city,23443,64440,89881,-40997,0.260822643,0.716947965,-0.456125321
Virginia,51720 ,Norton city,1109,464,1601,645,0.692692067,0.289818863,0.402873204
Virginia,51730 ,Petersburg city,1584,12389,14118,-10805,0.112197195,0.877532228,-0.765335033
Virginia,51735 ,Poquoson city,5605,2054,7857,3551,0.713376607,0.261422935,0.451953672
Virginia,51740 ,Portsmouth city,12755,30948,44582,-18193,0.286102014,0.694181508,-0.408079494
Virginia,51750 ,Radford city,2786,3358,6320,-572,0.440822785,0.531329114,-0.090506329
Virginia,51760 ,Richmond city,16603,92175,111159,-75572,0.149362625,0.829217607,-0.679854983
Virginia,51770 ,Roanoke city,15607,26773,43323,-11166,0.360247444,0.617985827,-0.257738384
Virginia,51775 ,Salem city,7683,5148,13051,2535,0.588690522,0.394452532,0.194237989
Virginia,51790 ,Staunton city,5695,6981,12990,-1286,0.438414165,0.537413395,-0.09899923
Virginia,51800 ,Suffolk city,20082,28676,49642,-8594,0.404536481,0.577656017,-0.173119536
Virginia,51810 ,Virginia Beach city,105087,117393,227561,-12306,0.461797057,0.515874864,-0.054077808
Virginia,51820 ,Waynesboro city,5507,4961,10717,546,0.51385649,0.462909396,0.050947093
Virginia,51830 ,Williamsburg city,1963,4790,6883,-2827,0.285195409,0.695917478,-0.410722069
Virginia,51840 ,Winchester city,5221,6610,12106,-1389,0.431273749,0.546010243,-0.114736494
Washington,53001 ,Adams County,3907,1814,5836,2093,0.669465387,0.310829335,0.358636052
Washington,53003 ,Asotin County,7319,4250,11880,3069,0.616077441,0.357744108,0.258333333
Washington,53005 ,Benton County,60365,38706,102307,21659,0.590037827,0.378331883,0.211705944
Washington,53007 ,Chelan County,22746,19349,43025,3397,0.528669378,0.449715282,0.078954096
Washington,53009 ,Clallam County,23062,24721,49025,-1659,0.470413055,0.504252932,-0.033839878
Washington,53011 ,Clark County,126303,140324,273451,-14021,0.46188531,0.513159579,-0.051274269
Washington,53013 ,Columbia County,1754,668,2482,1086,0.706688155,0.269137792,0.437550363
Washington,53015 ,Cowlitz County,34424,23938,59969,10486,0.574029915,0.399172906,0.174857009
Washington,53017 ,Douglas County,12955,7811,21183,5144,0.61157532,0.368739083,0.242836237
Washington,53019 ,Ferry County,2771,1486,4351,1285,0.636865088,0.341530683,0.295334406
Washington,53021 ,Franklin County,18039,13340,32226,4699,0.559765407,0.413951468,0.145813939
Washington,53023 ,Garfield County,1069,366,1481,703,0.721809588,0.247130317,0.474679271
Washington,53025 ,Grant County,24764,11819,37475,12945,0.660813876,0.315383589,0.345430287
Washington,53027 ,Grays Harbor County,19877,17354,38256,2523,0.519578628,0.453628189,0.065950439
Washington,53029 ,Island County,22746,29213,53539,-6467,0.424849175,0.545639627,-0.120790452
Washington,53031 ,Jefferson County,6931,17204,24658,-10273,0.281085246,0.697704599,-0.416619353
Washington,53033 ,King County,269167,907310,1202570,-638143,0.223826472,0.754475831,-0.530649359
Washington,53035 ,Kitsap County,61563,90277,157625,-28714,0.390566217,0.572732752,-0.182166534
Washington,53037 ,Kittitas County,14042,11246,26113,2796,0.537739823,0.430666718,0.107073105
Washington,53039 ,Klickitat County,7237,5959,13481,1278,0.536829612,0.442029523,0.094800089
Washington,53041 ,Lewis County,29391,14520,45077,14871,0.652017659,0.322115491,0.329902167
Washington,53043 ,Lincoln County,5150,1713,6993,3437,0.736450736,0.244959245,0.491491491
Washington,53045 ,Mason County,18710,17269,37112,1441,0.504149601,0.46532119,0.038828411
Washington,53047 ,Okanogan County,11840,8900,21152,2940,0.559757943,0.420763994,0.138993949
Washington,53049 ,Pacific County,6953,6794,14017,159,0.496040522,0.484697153,0.011343369
Washington,53051 ,Pend Oreille County,5728,2593,8513,3135,0.672853283,0.304592975,0.368260308
Washington,53053 ,Pierce County,197730,249506,460714,-51776,0.429181662,0.541563747,-0.112382085
Washington,53055 ,San Juan County,3057,9725,13090,-6668,0.233537051,0.742933537,-0.509396486
Washington,53057 ,Skagit County,32762,38252,72937,-5490,0.449182171,0.52445261,-0.075270439
Washington,53059 ,Skamania County,3885,3192,7268,693,0.534534948,0.439185471,0.095349477
Washington,53061 ,Snohomish County,166428,256728,435582,-90300,0.382081904,0.589390746,-0.207308842
Washington,53063 ,Spokane County,148576,135765,293294,12811,0.506577018,0.462897298,0.043679721
Washington,53065 ,Stevens County,19808,7839,28283,11969,0.700350034,0.27716296,0.423187074
Washington,53067 ,Thurston County,65277,96608,166965,-31331,0.390962178,0.578612284,-0.187650106
Washington,53069 ,Wahkiakum County,1741,1165,2972,576,0.585800808,0.391991925,0.193808883
Washington,53071 ,Walla Walla County,16400,13690,31055,2710,0.528095315,0.440830784,0.087264531
Washington,53073 ,Whatcom County,50489,83660,137660,-33171,0.366765945,0.607729188,-0.240963243
Washington,53075 ,Whitman County,9067,11184,20964,-2117,0.432503339,0.533485976,-0.100982637
Washington,53077 ,Yakima County,50555,43179,95713,7376,0.528193662,0.451129941,0.077063722
West Virginia,54001 ,Barbour County,5116,1457,6677,3659,0.766212371,0.218211772,0.548000599
West Virginia,54003 ,Berkeley County,33279,17186,51535,16093,0.645755312,0.3334821,0.312273212
West Virginia,54005 ,Boone County,6816,2041,9012,4775,0.7563249,0.22647581,0.52984909
West Virginia,54007 ,Braxton County,4120,1457,5664,2663,0.72740113,0.257238701,0.470162429
West Virginia,54009 ,Brooke County,7545,2947,10656,4598,0.708051802,0.276557808,0.431493994
West Virginia,54011 ,Cabell County,21721,14994,37360,6727,0.581397216,0.40133833,0.180058887
West Virginia,54013 ,Calhoun County,2364,568,2971,1796,0.795691686,0.19118142,0.604510266
West Virginia,54015 ,Clay County,2679,641,3365,2038,0.796136701,0.190490342,0.60564636
West Virginia,54017 ,Doddridge County,2619,435,3101,2184,0.844566269,0.14027733,0.704288939
West Virginia,54019 ,Fayette County,11580,5063,16862,6517,0.686751275,0.300260942,0.386490333
West Virginia,54021 ,Gilmer County,2012,599,2662,1413,0.75582269,0.225018783,0.530803907
West Virginia,54023 ,Grant County,4871,607,5509,4264,0.884189508,0.110183336,0.774006172
West Virginia,54025 ,Greenbrier County,10925,4655,15850,6270,0.689274448,0.293690852,0.395583596
West Virginia,54027 ,Hampshire County,8033,1939,10086,6094,0.796450525,0.192246679,0.604203847
West Virginia,54029 ,Hancock County,9806,3790,13800,6016,0.71057971,0.274637681,0.435942029
West Virginia,54031 ,Hardy County,4859,1381,6331,3478,0.767493287,0.218132996,0.549360291
West Virginia,54033 ,Harrison County,20683,9215,30465,11468,0.678910225,0.302478254,0.376431971
West Virginia,54035 ,Jackson County,10093,3207,13508,6886,0.747186852,0.237414865,0.509771987
West Virginia,54037 ,Jefferson County,15033,12127,27703,2906,0.542648811,0.437750424,0.104898386
West Virginia,54039 ,Kanawha County,46398,34344,82244,12054,0.564150576,0.417586693,0.146563883
West Virginia,54041 ,Lewis County,5782,1538,7457,4244,0.775378839,0.206249162,0.569129677
West Virginia,54043 ,Lincoln County,6012,1711,7830,4301,0.767816092,0.218518519,0.549297573
West Virginia,54045 ,Logan County,10534,2333,13026,8201,0.808690312,0.179103332,0.62958698
West Virginia,54047 ,McDowell County,5148,1333,6527,3815,0.788723763,0.204228589,0.584495174
West Virginia,54049 ,Marion County,16300,8901,25794,7399,0.631929906,0.345080251,0.286849655
West Virginia,54051 ,Marshall County,10435,3455,14080,6980,0.741122159,0.245383523,0.495738636
West Virginia,54053 ,Mason County,8491,2526,11203,5965,0.757921985,0.225475319,0.532446666
West Virginia,54055 ,Mercer County,19237,5556,25134,13681,0.765377576,0.221055144,0.544322432
West Virginia,54057 ,Mineral County,10040,2660,12872,7380,0.77998757,0.206650093,0.573337477
West Virginia,54059 ,Mingo County,8544,1397,10022,7147,0.852524446,0.139393335,0.713131112
West Virginia,54061 ,Monongalia County,20803,20282,42072,521,0.494461875,0.482078342,0.012383533
West Virginia,54063 ,Monroe County,5068,1345,6490,3723,0.780893683,0.207241911,0.573651772
West Virginia,54065 ,Morgan County,6537,1998,8695,4539,0.751811386,0.229787234,0.522024152
West Virginia,54067 ,Nicholas County,8279,2226,10630,6053,0.77883349,0.209407338,0.569426152
West Virginia,54069 ,Ohio County,12354,7223,19898,5131,0.620866419,0.363001307,0.257865112
West Virginia,54071 ,Pendleton County,2782,820,3659,1962,0.760317027,0.224104947,0.53621208
West Virginia,54073 ,Pleasants County,2742,699,3491,2043,0.785448296,0.200229161,0.585219135
West Virginia,54075 ,Pocahontas County,2895,1047,4008,1848,0.722305389,0.261227545,0.461077844
West Virginia,54077 ,Preston County,11190,3163,14572,8027,0.767911062,0.217060115,0.550850947
West Virginia,54079 ,Putnam County,20034,7878,28501,12156,0.702922704,0.276411354,0.42651135
West Virginia,54081 ,Raleigh County,24673,7982,33106,16691,0.74527276,0.241104332,0.504168429
West Virginia,54083 ,Randolph County,8673,3362,12200,5311,0.710901639,0.27557377,0.435327869
West Virginia,54085 ,Ritchie County,3649,586,4283,3063,0.851972916,0.136819986,0.71515293
West Virginia,54087 ,Roane County,4213,1455,5763,2758,0.73104286,0.25247267,0.478570189
West Virginia,54089 ,Summers County,4074,1448,5585,2626,0.729453894,0.259265891,0.470188004
West Virginia,54091 ,Taylor County,5477,1796,7383,3681,0.741839361,0.243261547,0.498577814
West Virginia,54093 ,Tucker County,2841,938,3844,1903,0.739073881,0.244016649,0.495057232
West Virginia,54095 ,Tyler County,3226,631,3922,2595,0.822539521,0.160887302,0.661652218
West Virginia,54097 ,Upshur County,7771,2256,10221,5515,0.760297427,0.220722043,0.539575384
West Virginia,54099 ,Wayne County,12585,4088,16947,8497,0.742609311,0.241222635,0.501386676
West Virginia,54101 ,Webster County,2759,610,3402,2149,0.810993533,0.17930629,0.631687243
West Virginia,54103 ,Wetzel County,4993,1539,6667,3454,0.748912554,0.230838458,0.518074096
West Virginia,54105 ,Wirt County,2134,466,2653,1668,0.804372409,0.175650207,0.628722201
West Virginia,54107 ,Wood County,27202,10926,38762,16276,0.701769775,0.281874,0.419895774
West Virginia,54109 ,Wyoming County,7353,1157,8592,6196,0.855796089,0.134660149,0.72113594
Wisconsin,55001 ,Adams County,7362,4329,11818,3033,0.622948045,0.366305635,0.25664241
Wisconsin,55003 ,Ashland County,3841,4801,8757,-960,0.438620532,0.548247117,-0.109626584
Wisconsin,55005 ,Barron County,15803,9194,25346,6609,0.623490886,0.362739683,0.260751203
Wisconsin,55007 ,Bayfield County,4617,6147,10880,-1530,0.424356618,0.564981618,-0.140625
Wisconsin,55009 ,Brown County,75871,65511,144017,10360,0.52681975,0.454883798,0.071935952
Wisconsin,55011 ,Buffalo County,4834,2860,7816,1974,0.618474923,0.36591607,0.252558854
Wisconsin,55013 ,Burnett County,6462,3569,10141,2893,0.637215265,0.351937679,0.285277586
Wisconsin,55015 ,Calumet County,18156,12116,30774,6040,0.589978553,0.393708975,0.196269578
Wisconsin,55017 ,Chippewa County,21317,13983,35938,7334,0.593160443,0.389086761,0.204073682
Wisconsin,55019 ,Clark County,10002,4524,14898,5478,0.671365284,0.303664921,0.367700362
Wisconsin,55021 ,Columbia County,16927,16410,33869,517,0.499778559,0.484513862,0.015264696
Wisconsin,55023 ,Crawford County,4620,3953,8695,667,0.53133985,0.454629097,0.076710753
Wisconsin,55025 ,Dane County,78800,260185,344791,-181385,0.228544249,0.754616565,-0.526072316
Wisconsin,55027 ,Dodge County,31355,16356,48436,14999,0.647349079,0.337682715,0.309666364
Wisconsin,55029 ,Door County,9752,10044,20117,-292,0.48476413,0.499279217,-0.014515087
Wisconsin,55031 ,Douglas County,10923,13218,24677,-2295,0.442638895,0.535640475,-0.09300158
Wisconsin,55033 ,Dunn County,13173,9897,23524,3276,0.559981296,0.420719265,0.13926203
Wisconsin,55035 ,Eau Claire County,25341,31620,58275,-6279,0.434851995,0.542599743,-0.107747748
Wisconsin,55037 ,Florence County,2133,781,2940,1352,0.725510204,0.265646259,0.459863946
Wisconsin,55039 ,Fond du Lac County,35754,20588,57251,15166,0.624513109,0.359609439,0.26490367
Wisconsin,55041 ,Forest County,3285,1721,5053,1564,0.650108846,0.340589749,0.309519098
Wisconsin,55043 ,Grant County,14142,10998,25608,3144,0.552249297,0.429475164,0.122774133
Wisconsin,55045 ,Green County,10169,10851,21406,-682,0.475053723,0.506913949,-0.031860226
Wisconsin,55047 ,Green Lake County,7168,3344,10671,3824,0.671727111,0.313372692,0.358354419
Wisconsin,55049 ,Iowa County,5909,7828,13992,-1919,0.42231275,0.55946255,-0.1371498
Wisconsin,55051 ,Iron County,2438,1533,4010,905,0.60798005,0.382294264,0.225685786
Wisconsin,55053 ,Jackson County,5791,4256,10184,1535,0.568637078,0.417910448,0.15072663
Wisconsin,55055 ,Jefferson County,27208,19904,47979,7304,0.567081431,0.414848163,0.152233269
Wisconsin,55057 ,Juneau County,8749,4746,13709,4003,0.638193887,0.34619593,0.291997958
Wisconsin,55059 ,Kenosha County,44972,42193,88738,2779,0.506795285,0.475478375,0.03131691
Wisconsin,55061 ,Kewaunee County,7927,3976,12095,3951,0.655394791,0.328730881,0.326663911
Wisconsin,55063 ,La Crosse County,28684,37846,67884,-9162,0.42254434,0.55750987,-0.134965529
Wisconsin,55065 ,Lafayette County,4821,3647,8555,1174,0.563530099,0.426300409,0.13722969
Wisconsin,55067 ,Langlade County,7330,3704,11165,3626,0.656515898,0.331751008,0.32476489
Wisconsin,55069 ,Lincoln County,10017,6261,16497,3756,0.607201309,0.37952355,0.22767776
Wisconsin,55071 ,Manitowoc County,27218,16818,44829,10400,0.607151621,0.375158937,0.231992683
Wisconsin,55073 ,Marathon County,44624,30808,76751,13816,0.58141262,0.401401936,0.180010684
Wisconsin,55075 ,Marinette County,15304,7366,22979,7938,0.665999391,0.320553549,0.345445842
Wisconsin,55077 ,Marquette County,5719,3239,9065,2480,0.630888031,0.357308329,0.273579702
Wisconsin,55078 ,Menominee County,278,1303,1590,-1025,0.174842767,0.819496855,-0.644654088
Wisconsin,55079 ,Milwaukee County,134357,317270,458971,-182913,0.292735271,0.691263718,-0.398528447
Wisconsin,55081 ,Monroe County,13775,8433,22611,5342,0.609216753,0.372960064,0.236256689
Wisconsin,55083 ,Oconto County,16226,6715,23215,9511,0.698944648,0.289252638,0.409692009
Wisconsin,55085 ,Oneida County,13671,10105,24159,3566,0.565876071,0.418270624,0.147605447
Wisconsin,55087 ,Outagamie County,58385,47667,108022,10718,0.540491752,0.441271223,0.099220529
Wisconsin,55089 ,Ozaukee County,33912,26517,61486,7395,0.551540188,0.431268907,0.120271281
Wisconsin,55091 ,Pepin County,2584,1489,4144,1095,0.623552124,0.359314672,0.264237452
Wisconsin,55093 ,Pierce County,12903,9839,23458,3064,0.550046892,0.419430471,0.130616421
Wisconsin,55095 ,Polk County,16611,9370,26371,7241,0.629896477,0.35531455,0.274581927
Wisconsin,55097 ,Portage County,19299,20428,40603,-1129,0.475309706,0.503115533,-0.027805827
Wisconsin,55099 ,Price County,5394,3032,8546,2362,0.631172478,0.354785865,0.276386614
Wisconsin,55101 ,Racine County,54479,50159,106451,4320,0.511775371,0.471193319,0.040582052
Wisconsin,55103 ,Richland County,4871,3995,9014,876,0.540381629,0.443199467,0.097182161
Wisconsin,55105 ,Rock County,37138,46658,85360,-9520,0.435074977,0.546602624,-0.111527648
Wisconsin,55107 ,Rusk County,5257,2517,7886,2740,0.666624398,0.319173218,0.347451179
Wisconsin,55109 ,St. Croix County,32199,23190,56707,9009,0.567813497,0.408944222,0.158869275
Wisconsin,55111 ,Sauk County,17493,18108,36203,-615,0.483192001,0.500179543,-0.016987542
Wisconsin,55113 ,Sawyer County,5909,4498,10510,1411,0.562226451,0.427973359,0.134253092
Wisconsin,55115 ,Shawano County,15173,7131,22607,8042,0.671163799,0.315433273,0.355730526
Wisconsin,55117 ,Sheboygan County,37609,27101,66003,10508,0.569807433,0.410602548,0.159204885
Wisconsin,55119 ,Taylor County,7655,2693,10684,4962,0.716491951,0.252059154,0.464432797
Wisconsin,55121 ,Trempealeau County,8833,6285,15220,2548,0.580354796,0.412943495,0.167411301
Wisconsin,55123 ,Vernon County,8218,7457,15914,761,0.516400654,0.468581124,0.04781953
Wisconsin,55125 ,Vilas County,9261,5903,15369,3358,0.602576615,0.384084846,0.218491769
Wisconsin,55127 ,Walworth County,33851,22789,57600,11062,0.587690972,0.395642361,0.192048611
Wisconsin,55129 ,Washburn County,6334,3867,10378,2467,0.610329543,0.372615147,0.237714396
Wisconsin,55131 ,Washington County,60237,26650,88070,33587,0.683967299,0.302600204,0.381367094
Wisconsin,55133 ,Waukesha County,159649,103906,267996,55743,0.595714115,0.387714742,0.207999373
Wisconsin,55135 ,Waupaca County,18952,9703,29130,9249,0.650600755,0.333093031,0.317507724
Wisconsin,55137 ,Waushara County,9016,4388,13568,4628,0.664504717,0.323408019,0.341096698
Wisconsin,55139 ,Winnebago County,47796,44060,94160,3736,0.507604078,0.467926933,0.039677145
Wisconsin,55141 ,Wood County,24308,16365,41298,7943,0.588599932,0.396266163,0.192333769
Wyoming,56001 ,Albany County,8579,9092,18617,-513,0.460815384,0.488370844,-0.02755546
Wyoming,56003 ,Big Horn County,4806,788,5752,4018,0.835535466,0.136995828,0.698539638
Wyoming,56005 ,Campbell County,16975,1935,19566,15040,0.867576408,0.098896044,0.768680364
Wyoming,56007 ,Carbon County,5014,1427,6664,3587,0.75240096,0.214135654,0.538265306
Wyoming,56009 ,Converse County,5917,861,6970,5056,0.84892396,0.123529412,0.725394548
Wyoming,56011 ,Crook County,3651,378,4119,3273,0.886380189,0.091769847,0.794610342
Wyoming,56013 ,Fremont County,12007,5519,18111,6488,0.662967257,0.304731931,0.358235327
Wyoming,56015 ,Goshen County,4878,1203,6241,3675,0.781605512,0.192757571,0.588847941
Wyoming,56017 ,Hot Springs County,1999,482,2577,1517,0.775708188,0.187039193,0.588668995
Wyoming,56019 ,Johnson County,3881,897,4914,2984,0.78978429,0.182539683,0.607244607
Wyoming,56021 ,Laramie County,27891,15217,44982,12674,0.620048019,0.338290872,0.281757147
Wyoming,56023 ,Lincoln County,8643,1509,10468,7134,0.825659152,0.144153611,0.681505541
Wyoming,56025 ,Natrona County,25271,8530,35202,16741,0.717885347,0.242315778,0.47556957
Wyoming,56027 ,Niobrara County,1118,155,1308,963,0.854740061,0.118501529,0.736238532
Wyoming,56029 ,Park County,12813,3410,16717,9403,0.766465275,0.203983968,0.562481306
Wyoming,56031 ,Platte County,3898,890,4923,3008,0.791793622,0.180784075,0.611009547
Wyoming,56033 ,Sheridan County,11843,4043,16428,7800,0.720903336,0.246104212,0.474799123
Wyoming,56035 ,Sublette County,3957,882,4970,3075,0.796177062,0.177464789,0.618712274
Wyoming,56037 ,Sweetwater County,12229,3823,16603,8406,0.736553635,0.230259592,0.506294043
Wyoming,56039 ,Teton County,4341,9848,14677,-5507,0.29576889,0.670981808,-0.375212918
Wyoming,56041 ,Uinta County,7496,1591,9402,5905,0.797277175,0.169219315,0.62805786
Wyoming,56043 ,Washakie County,3245,651,4012,2594,0.808823529,0.16226321,0.646560319
Wyoming,56045 ,Weston County,3107,360,3542,2747,0.877188029,0.101637493,0.775550536
