votes_dem,votes_gop,total_votes,per_dem,per_gop,diff,per_point_diff,state_abbr,county_name,combined_fips
7503,19838,27770,0.270183651,0.714368023,12335,0.444184372,AL,Autauga County,1001
24578,83544,109679,0.2240903,0.761713728,58966,0.537623428,AL,Baldwin County,1003
4816,5622,10518,0.457881727,0.534512265,806,0.076630538,AL,Barbour County,1005
1986,7525,9595,0.206982804,0.784262637,5539,0.577279833,AL,Bibb County,1007
2640,24711,27588,0.09569378,0.895715528,22071,0.800021749,AL,Blount County,1009
3446,1146,4613,0.747019293,0.248428355,-2300,-0.498590939,AL,Bullock County,1011
3965,5458,9488,0.41789629,0.575252951,1493,0.157356661,AL,Butler County,1013
15216,35101,50983,0.298452425,0.688484397,19885,0.390031971,AL,Calhoun County,1015
6365,8753,15284,0.416448574,0.572690395,2388,0.156241822,AL,Chambers County,1017
1624,10583,12301,0.132021787,0.860336558,8959,0.728314771,AL,Cherokee County,1019
3073,16085,19310,0.159140342,0.832988089,13012,0.673847747,AL,Chilton County,1021
3127,4296,7464,0.418944266,0.575562701,1169,0.156618435,AL,Choctaw County,1023
5755,7324,13135,0.438142368,0.557594214,1569,0.119451846,AL,Clarke County,1025
1267,5601,6930,0.182828283,0.808225108,4334,0.625396825,AL,Clay County,1027
675,6484,7227,0.093399751,0.897191089,5809,0.803791338,AL,Cleburne County,1029
5076,16899,22275,0.227878788,0.758653199,11823,0.530774411,AL,Coffee County,1031
8343,19203,27886,0.299182385,0.688625117,10860,0.389442731,AL,Colbert County,1033
2966,3442,6441,0.460487502,0.53438907,476,0.073901568,AL,Conecuh County,1035
1796,3631,5479,0.327797043,0.662712174,1835,0.33491513,AL,Coosa County,1037
2721,14586,17430,0.156110155,0.836833046,11865,0.680722892,AL,Covington County,1039
1700,4864,6617,0.256914009,0.735076319,3164,0.478162309,AL,Crenshaw County,1041
4478,36880,41851,0.106998638,0.881221476,32402,0.774222838,AL,Cullman County,1043
5170,14303,19738,0.2619313,0.724642821,9133,0.462711521,AL,Dale County,1045
12230,5524,17864,0.684617107,0.309225258,-6706,-0.37539185,AL,Dallas County,1047
4281,24767,29356,0.145830495,0.843677613,20486,0.697847118,AL,DeKalb County,1049
10367,30164,41030,0.252668779,0.735169388,19797,0.482500609,AL,Elmore County,1051
4918,10869,15910,0.309113765,0.683155248,5951,0.374041483,AL,Escambia County,1053
11567,35528,47728,0.242352497,0.744384847,23961,0.50203235,AL,Etowah County,1055
1395,7300,8766,0.159137577,0.832762948,5905,0.673625371,AL,Fayette County,1057
2086,10376,12578,0.165845126,0.824932422,8290,0.659087295,AL,Franklin County,1059
1595,10848,12545,0.127142288,0.864726983,9253,0.737584695,AL,Geneva County,1061
3884,875,4775,0.813403141,0.183246073,-3009,-0.630157068,AL,Greene County,1063
4663,3192,7900,0.590253165,0.404050633,-1471,-0.186202532,AL,Hale County,1065
2606,6607,9298,0.280275328,0.710582921,4001,0.430307593,AL,Henry County,1067
12917,32618,46173,0.279752236,0.706430165,19701,0.426677929,AL,Houston County,1069
3717,19670,23636,0.157260112,0.832205111,15953,0.674944999,AL,Jackson County,1071
181688,138843,325848,0.557585132,0.426097444,-42845,-0.131487688,AL,Jefferson County,1073
978,6174,7193,0.135965522,0.858334492,5196,0.72236897,AL,Lamar County,1075
11915,31721,44339,0.26872505,0.715419834,19806,0.446694783,AL,Lauderdale County,1077
3562,12322,16031,0.222194498,0.768635768,8760,0.54644127,AL,Lawrence County,1079
27860,42221,71449,0.38992848,0.590924995,14361,0.200996515,AL,Lee County,1081
13672,34640,49235,0.277688636,0.703564537,20968,0.425875901,AL,Limestone County,1083
4972,1836,6835,0.727432334,0.26861741,-3136,-0.458814923,AL,Lowndes County,1085
7108,1541,8723,0.814857274,0.176659406,-5567,-0.638197868,AL,Macon County,1087
87286,102780,194767,0.448156002,0.527707466,15494,0.079551464,AL,Madison County,1089
5488,5343,10900,0.503486239,0.490183486,-145,-0.013302752,AL,Marengo County,1091
1463,12205,13807,0.105960745,0.883971898,10742,0.778011154,AL,Marion County,1093
5943,33191,39655,0.149867608,0.836994074,27248,0.687126466,AL,Marshall County,1095
79474,101243,183164,0.433895307,0.552745081,21769,0.118849774,AL,Mobile County,1097
4455,6147,10668,0.417604049,0.576209224,1692,0.158605174,AL,Monroe County,1099
64529,33311,99139,0.650894199,0.336002986,-31218,-0.314891213,AL,Montgomery County,1101
13234,39664,53722,0.246342281,0.738319497,26430,0.491977216,AL,Morgan County,1103
3860,1339,5230,0.738049713,0.256022945,-2521,-0.482026769,AL,Perry County,1105
4022,5594,9668,0.416011585,0.578609847,1572,0.162598262,AL,Pickens County,1107
5636,8042,13841,0.407196012,0.581027382,2406,0.173831371,AL,Pike County,1109
2203,8559,10837,0.203285042,0.789794223,6356,0.586509182,AL,Randolph County,1111
11228,9864,21329,0.526419429,0.462468939,-1364,-0.06395049,AL,Russell County,1113
7744,36166,44441,0.174253505,0.813798069,28422,0.639544565,AL,St. Clair County,1115
33268,79700,114950,0.289412788,0.693344933,46432,0.403932144,AL,Shelby County,1117
4648,1598,6291,0.738833254,0.25401367,-3050,-0.484819584,AL,Sumter County,1119
13138,22235,35663,0.368393012,0.623475311,9097,0.255082298,AL,Talladega County,1121
5859,14963,20991,0.279119623,0.712829308,9104,0.433709685,AL,Tallapoosa County,1123
37765,51117,90172,0.418810717,0.56688329,13352,0.148072572,AL,Tuscaloosa County,1125
4834,26002,31170,0.155085018,0.834199551,21168,0.679114533,AL,Walker County,1127
2258,6564,8876,0.254393871,0.739522307,4306,0.485128436,AL,Washington County,1129
4048,1833,5903,0.685753007,0.310520075,-2215,-0.375232932,AL,Wilcox County,1131
974,10195,11284,0.086316909,0.90349167,9221,0.817174761,AL,Winston County,1133
3476,3509,7311,0.475447955,0.479961702,33,0.004513746,AK,District 1,2901
2102,3671,6131,0.342847823,0.598760398,1569,0.255912575,AK,District 2,2902
1902,6070,8375,0.227104478,0.724776119,4168,0.497671642,AK,District 3,2903
5347,4687,10585,0.505148795,0.44279641,-660,-0.062352385,AK,District 4,2904
4203,4077,8653,0.485727493,0.47116607,-126,-0.014561424,AK,District 5,2905
3264,5750,9430,0.346129374,0.609756098,2486,0.263626723,AK,District 6,2906
2212,7023,9614,0.230081132,0.730497192,4811,0.50041606,AK,District 7,2907
1952,7590,9883,0.197510877,0.76798543,5638,0.570474552,AK,District 8,2908
2768,7781,10986,0.251957036,0.708265065,5013,0.456308028,AK,District 9,2909
2724,8069,11190,0.243431635,0.721090259,5345,0.477658624,AK,District 10,2910
3129,7092,10623,0.294549562,0.66760802,3963,0.373058458,AK,District 11,2911
2954,7871,11213,0.263444217,0.70195309,4917,0.438508874,AK,District 12,2912
2663,4649,7707,0.345530038,0.603217854,1986,0.257687816,AK,District 13,2913
4260,6711,11437,0.372475299,0.58677975,2451,0.21430445,AK,District 14,2914
2614,2658,5538,0.472011557,0.479956663,44,0.007945107,AK,District 15,2915
4273,3519,8121,0.526166728,0.43332102,-754,-0.092845709,AK,District 16,2916
4095,2774,7159,0.572007264,0.387484286,-1321,-0.184522978,AK,District 17,2917
4679,2754,7711,0.606795487,0.35715212,-1925,-0.249643367,AK,District 18,2918
3115,1971,5294,0.588401964,0.372308274,-1144,-0.216093691,AK,District 19,2919
4834,2350,7410,0.652361673,0.317139001,-2484,-0.335222672,AK,District 20,2920
5409,3685,9419,0.574264784,0.391230492,-1724,-0.183034292,AK,District 21,2921
4541,4662,9484,0.478806411,0.491564741,121,0.01275833,AK,District 22,2922
3796,3636,7705,0.492667099,0.471901363,-160,-0.020765737,AK,District 23,2923
4734,5374,10422,0.454231434,0.515639992,640,0.061408559,AK,District 24,2924
4592,4385,9294,0.494082204,0.47180977,-207,-0.022272434,AK,District 25,2925
4557,5241,10108,0.450831025,0.518500198,684,0.067669173,AK,District 26,2926
4843,4319,9499,0.509843141,0.45467944,-524,-0.055163701,AK,District 27,2927
6259,6154,12736,0.491441583,0.483197236,-105,-0.008244347,AK,District 28,2928
2984,7455,10737,0.277917482,0.694328025,4471,0.416410543,AK,District 29,2929
2637,7182,10177,0.259113688,0.705708952,4545,0.446595264,AK,District 30,2930
5032,6956,12389,0.406166761,0.561465816,1924,0.155299056,AK,District 31,2931
3496,4429,8313,0.420546133,0.532779983,933,0.112233851,AK,District 32,2932
7534,3058,10952,0.687910884,0.279218408,-4476,-0.408692476,AK,District 33,2933
5762,4542,10727,0.53714925,0.423417545,-1220,-0.113731705,AK,District 34,2934
5010,4768,10100,0.496039604,0.472079208,-242,-0.023960396,AK,District 35,2935
3795,5112,9289,0.408547745,0.550328345,1317,0.141780601,AK,District 36,2936
2522,2324,5066,0.497828662,0.458744572,-198,-0.03908409,AK,District 37,2937
3202,1737,5299,0.604264956,0.327797698,-1465,-0.276467258,AK,District 38,2938
3550,1896,5811,0.610910342,0.326277749,-1654,-0.284632593,AK,District 39,2939
2308,1993,4590,0.502832244,0.434204793,-315,-0.068627451,AK,District 40,2940
23293,11442,35172,0.662259752,0.325315592,-11851,-0.33694416,AZ,Apache County,4001
23732,35557,60442,0.392640879,0.588282982,11825,0.195642103,AZ,Cochise County,4003
44698,27052,73272,0.610028387,0.369199694,-17646,-0.240828693,AZ,Coconino County,4005
8943,18377,27662,0.323295496,0.664340973,9434,0.341045478,AZ,Gila County,4007
4034,10749,14995,0.269023008,0.716838946,6715,0.447815939,AZ,Graham County,4009
1182,2433,3685,0.320759837,0.660244233,1251,0.339484396,AZ,Greenlee County,4011
2236,5129,7458,0.299812282,0.687717887,2893,0.387905605,AZ,La Paz County,4012
1040774,995665,2068144,0.503240587,0.481429243,-45109,-0.021811344,AZ,Maricopa County,4013
24831,78535,104668,0.237235831,0.750324837,53704,0.513089005,AZ,Mohave County,4015
23383,27657,51767,0.451697027,0.534259277,4274,0.08256225,AZ,Navajo County,4017
304981,207758,520397,0.586054493,0.399229819,-97223,-0.186824674,AZ,Pima County,4019
75106,107077,185525,0.404829538,0.577156717,31971,0.17232718,AZ,Pinal County,4021
13138,6194,19556,0.671814277,0.316731438,-6944,-0.355082839,AZ,Santa Cruz County,4023
49602,91527,143221,0.346331893,0.639061311,41925,0.292729418,AZ,Yavapai County,4025
32210,36534,69881,0.460926432,0.522803051,4324,0.061876619,AZ,Yuma County,4027
1818,4304,6292,0.288938334,0.684043229,2486,0.395104895,AR,Arkansas County,5001
2125,5548,7926,0.268104971,0.699974767,3423,0.431869796,AR,Ashley County,5003
4635,15836,21007,0.220640739,0.753843957,11201,0.533203218,AR,Baxter County,5005
42249,73965,119912,0.352333378,0.61682734,31716,0.264493962,AR,Benton County,5007
3064,13652,17114,0.179034708,0.797709478,10588,0.618674769,AR,Boone County,5009
1214,2335,3654,0.332238643,0.639025725,1121,0.306787083,AR,Bradley County,5011
479,1636,2182,0.219523373,0.749770852,1157,0.530247479,AR,Calhoun County,5013
4023,7424,11797,0.341018903,0.629312537,3401,0.288293634,AR,Carroll County,5015
2260,1752,4103,0.550816476,0.427004631,-508,-0.123811845,AR,Chicot County,5017
3438,4616,8395,0.409529482,0.549851102,1178,0.14032162,AR,Clark County,5019
962,4086,5183,0.185606791,0.788346517,3124,0.602739726,AR,Clay County,5021
1988,10328,12680,0.156782334,0.814511041,8340,0.657728707,AR,Cleburne County,5023
651,2867,3600,0.180833333,0.796388889,2216,0.615555556,AR,Cleveland County,5025
2814,5500,8616,0.326601671,0.638347261,2686,0.31174559,AR,Columbia County,5027
2615,5694,8685,0.30109384,0.655613126,3079,0.354519286,AR,Conway County,5029
11921,25558,38511,0.309547921,0.66365454,13637,0.354106619,AR,Craighead County,5031
4959,18607,24091,0.205844506,0.772363123,13648,0.566518617,AR,Crawford County,5033
8514,7333,16367,0.520193071,0.448035682,-1181,-0.07215739,AR,Crittenden County,5035
1772,4946,6942,0.255257851,0.712474791,3174,0.45721694,AR,Cross County,5037
963,1573,2649,0.363533409,0.593808985,610,0.230275576,AR,Dallas County,5039
2016,1921,4164,0.484149856,0.461335255,-95,-0.022814601,AR,Desha County,5041
2426,4349,6908,0.35118703,0.629559931,1923,0.278372901,AR,Drew County,5043
18347,34421,54428,0.337087528,0.632413464,16074,0.295325935,AR,Faulkner County,5045
1300,5677,7129,0.182353766,0.79632487,4377,0.613971104,AR,Franklin County,5047
1035,3961,5119,0.202187927,0.773783942,2926,0.571596015,AR,Fulton County,5049
14045,29069,44199,0.31776737,0.657684563,15024,0.339917193,AR,Garland County,5051
1268,6794,8200,0.154634146,0.828536585,5526,0.673902439,AR,Grant County,5053
3058,12670,16100,0.189937888,0.786956522,9612,0.597018634,AR,Greene County,5055
2138,4470,6848,0.312207944,0.652745327,2332,0.340537383,AR,Hempstead County,5057
3082,9202,12557,0.24544079,0.732818348,6120,0.487377558,AR,Hot Spring County,5059
1340,3367,4834,0.277203144,0.696524617,2027,0.419321473,AR,Howard County,5061
2806,11250,14512,0.193357222,0.775220507,8444,0.581863286,AR,Independence County,5063
1021,4631,5810,0.175731497,0.79707401,3610,0.621342513,AR,Izard County,5065
1365,3593,5091,0.268120212,0.705755254,2228,0.437635042,AR,Jackson County,5067
14981,9521,25158,0.595476588,0.378448207,-5460,-0.217028381,AR,Jefferson County,5069
2283,6938,9498,0.240366393,0.730469573,4655,0.49010318,AR,Johnson County,5071
839,1757,2679,0.313176558,0.655841732,918,0.342665174,AR,Lafayette County,5073
1080,4569,5857,0.184394741,0.780092197,3489,0.595697456,AR,Lawrence County,5075
1423,1286,2848,0.499648876,0.451544944,-137,-0.048103933,AR,Lee County,5077
1032,2729,3875,0.266322581,0.704258065,1697,0.437935484,AR,Lincoln County,5079
1226,3715,5177,0.236816689,0.717597064,2489,0.480780375,AR,Little River County,5081
1544,6441,8225,0.187720365,0.783100304,4897,0.595379939,AR,Logan County,5083
6686,22884,30662,0.218054921,0.746330963,16198,0.528276042,AR,Lonoke County,5085
1563,5658,7351,0.212624133,0.769691198,4095,0.557067066,AR,Madison County,5087
1531,5783,7503,0.204051713,0.770758363,4252,0.566706651,AR,Marion County,5089
4245,11920,16529,0.256821344,0.721156755,7675,0.46433541,AR,Miller County,5091
4542,7262,12287,0.369658989,0.591031171,2720,0.221372182,AR,Mississippi County,5093
1147,1545,2816,0.407315341,0.548650568,398,0.141335227,AR,Monroe County,5095
731,3046,3873,0.188742577,0.786470436,2315,0.59772786,AR,Montgomery County,5097
1076,2133,3358,0.320428827,0.635199524,1057,0.314770697,AR,Nevada County,5099
709,3192,3998,0.177338669,0.7983992,2483,0.62106053,AR,Newton County,5101
3995,5294,9629,0.414892512,0.549797487,1299,0.134904975,AR,Ouachita County,5103
1012,3479,4627,0.218716231,0.751891074,2467,0.533174843,AR,Perry County,5105
3623,2417,6242,0.580422941,0.387215636,-1206,-0.193207305,AR,Phillips County,5107
644,3519,4246,0.151672162,0.828780028,2875,0.677107866,AR,Pike County,5109
1424,5918,7521,0.189336524,0.786863449,4494,0.597526925,AR,Poinsett County,5111
1246,7035,8490,0.146760895,0.828621908,5789,0.681861013,AR,Polk County,5113
5772,18081,24432,0.236247544,0.740054028,12309,0.503806483,AR,Pope County,5115
654,2786,3495,0.187124464,0.79713877,2132,0.610014306,AR,Prairie County,5117
101947,63687,169956,0.599843489,0.3747264,-38260,-0.225117089,AR,Pulaski County,5119
1215,5355,6812,0.178361715,0.786112742,4140,0.607751028,AR,Randolph County,5121
3604,3242,7108,0.507034328,0.456105796,-362,-0.050928531,AR,St. Francis County,5123
16060,39556,56959,0.281957197,0.694464439,23496,0.412507242,AR,Saline County,5125
483,2962,3551,0.136018023,0.834131231,2479,0.698113208,AR,Scott County,5127
588,3365,4019,0.146305051,0.837272953,2777,0.690967902,AR,Searcy County,5129
14487,31198,47140,0.307318625,0.661815868,16711,0.354497242,AR,Sebastian County,5131
1116,3884,5202,0.214532872,0.746635909,2768,0.532103037,AR,Sevier County,5133
1398,5938,7566,0.184773989,0.784826857,4540,0.600052868,AR,Sharp County,5135
1180,4616,5938,0.198720108,0.777366117,3436,0.578646009,AR,Stone County,5137
5584,10478,16607,0.336243753,0.630938761,4894,0.294695008,AR,Union County,5139
1593,6034,7807,0.20404765,0.772896119,4441,0.568848469,AR,Van Buren County,5141
43824,47504,94266,0.464897206,0.503935671,3680,0.039038466,AR,Washington County,5143
5978,24182,30885,0.193556743,0.782969079,18204,0.589412336,AR,White County,5145
856,1543,2476,0.345718901,0.623182553,687,0.277463651,AR,Woodruff County,5147
1284,5226,6741,0.19047619,0.775255897,3942,0.584779706,AR,Yell County,5149
617486,136238,769617,0.802328951,0.177020518,-481248,-0.625308433,CA,Alameda County,6001
473,238,736,0.642663043,0.323369565,-235,-0.319293478,CA,Alpine County,6003
8153,13585,22302,0.365572594,0.609138194,5432,0.243565599,CA,Amador County,6005
50416,48723,102024,0.494158237,0.477564103,-1693,-0.016594135,CA,Butte County,6007
9845,16287,26717,0.368491971,0.609611858,6442,0.241119886,CA,Calaveras County,6009
3218,4539,7919,0.40636444,0.573178432,1321,0.166813992,CA,Colusa County,6011
415573,152497,579996,0.716510114,0.262927675,-263076,-0.453582438,CA,Contra Costa County,6013
4659,6444,11416,0.408111423,0.564470918,1785,0.156359495,CA,Del Norte County,6015
51606,61820,116101,0.444492296,0.532467421,10214,0.087975125,CA,El Dorado County,6017
192118,163880,363271,0.528855868,0.451123266,-28238,-0.077732602,CA,Fresno County,6019
3939,7000,11170,0.352641003,0.626678603,3061,0.274037601,CA,Glenn County,6021
43633,21069,66914,0.652075799,0.314866844,-22564,-0.337208955,CA,Humboldt County,6023
33636,20040,54819,0.613582882,0.365566683,-13596,-0.248016199,CA,Imperial County,6025
4623,4611,9460,0.488689218,0.487420719,-12,-0.001268499,CA,Inyo County,6027
129074,159980,296176,0.435801685,0.540151802,30906,0.104350116,CA,Kern County,6029
18409,23792,43273,0.425415386,0.549811661,5383,0.124396275,CA,Kings County,6031
6874,3955,11038,0.622757746,0.358307664,-2919,-0.264450082,CA,Lake County,6033
2775,8814,11800,0.235169492,0.746949153,6039,0.511779661,CA,Lassen County,6035
3024321,1143687,4256867,0.71045701,0.268668718,-1880634,-0.441788292,CA,Los Angeles County,6037
23154,29361,53690,0.431253492,0.546861613,6207,0.115608121,CA,Madera County,6039
128262,24610,155771,0.823401018,0.157988329,-103652,-0.665412689,CA,Marin County,6041
4088,5950,10280,0.39766537,0.578793774,1862,0.181128405,CA,Mariposa County,6043
28781,13267,43335,0.664151379,0.306149763,-15514,-0.358001615,CA,Mendocino County,6045
48991,39397,90541,0.541091881,0.435128837,-9594,-0.105963044,CA,Merced County,6047
1150,3109,4338,0.265099124,0.716689719,1959,0.451590595,CA,Modoc County,6049
4013,2513,6737,0.595665727,0.373014695,-1500,-0.222651032,CA,Mono County,6051
113953,46299,163883,0.695331425,0.282512524,-67654,-0.412818901,CA,Monterey County,6053
46962,19388,67847,0.692175041,0.285760608,-27574,-0.406414432,CA,Napa County,6055
36359,26779,64738,0.561633044,0.413651951,-9580,-0.147981093,CA,Nevada County,6057
814005,676496,1521719,0.534924648,0.444560395,-137509,-0.090364253,CA,Orange County,6059
104134,119013,228616,0.455497428,0.520580362,14879,0.065082934,CA,Placer County,6061
4561,6445,11256,0.405206112,0.572583511,1884,0.167377399,CA,Plumas County,6063
527475,448281,995249,0.529992997,0.45042095,-79194,-0.079572047,CA,Riverside County,6065
440790,259394,718260,0.613691421,0.361142205,-181396,-0.252549216,CA,Sacramento County,6067
17315,10412,28317,0.611470142,0.367694318,-6903,-0.243775824,CA,San Benito County,6069
453380,364325,836393,0.542065751,0.435590685,-89055,-0.106475066,CA,San Bernardino County,6071
963797,599539,1600272,0.602270739,0.374648185,-364258,-0.227622554,CA,San Diego County,6073
377772,56329,442969,0.852818143,0.127162397,-321443,-0.725655746,CA,San Francisco County,6075
154460,115378,275706,0.560234453,0.418482006,-39082,-0.141752446,CA,San Joaquin County,6077
87491,66661,158035,0.553617869,0.421811624,-20830,-0.131806245,CA,San Luis Obispo County,6079
291215,75505,373800,0.779066346,0.201993044,-215710,-0.577073301,CA,San Mateo County,6081
126419,63583,194378,0.6503771,0.327110064,-62836,-0.323267036,CA,Santa Barbara County,6083
617824,214538,850297,0.726597883,0.252309487,-403286,-0.474288396,CA,Santa Clara County,6085
113874,26821,144295,0.789174954,0.185876156,-87053,-0.603298798,CA,Santa Cruz County,6087
29874,60372,92326,0.323570825,0.65390031,30498,0.330329485,CA,Shasta County,6089
730,1142,1930,0.378238342,0.591709845,412,0.213471503,CA,Sierra County,6091
9591,13288,23446,0.409067645,0.566749126,3697,0.157681481,CA,Siskiyou County,6093
131639,69306,205831,0.63954895,0.336713129,-62333,-0.302835822,CA,Solano County,6095
199938,61825,268252,0.745336475,0.230473585,-138113,-0.51486289,CA,Sonoma County,6097
105841,104145,214876,0.492567807,0.484674882,-1696,-0.007892924,CA,Stanislaus County,6099
17364,24372,42634,0.407280574,0.571656424,7008,0.16437585,CA,Sutter County,6101
8802,18865,28319,0.31081606,0.666160528,10063,0.355344468,CA,Tehama County,6103
2851,3188,6258,0.455576862,0.509427932,337,0.053851071,CA,Trinity County,6105
65944,77413,146487,0.45016964,0.528463277,11469,0.078293637,CA,Tulare County,6107
11978,17689,30401,0.394000197,0.58185586,5711,0.187855663,CA,Tuolumne County,6109
251298,162146,422539,0.594733267,0.383742092,-89152,-0.210991175,CA,Ventura County,6111
58328,22422,82624,0.705945004,0.271373935,-35906,-0.434571069,CA,Yolo County,6113
10343,16210,27329,0.378462439,0.593142815,5867,0.214680376,CA,Yuba County,6115
134202,95657,236735,0.566887026,0.40406784,-38545,-0.162819186,CO,Adams County,8001
3759,3813,7808,0.481429303,0.488345287,54,0.006915984,CO,Alamosa County,8003
213607,127323,350183,0.609986778,0.363589894,-86284,-0.246396884,CO,Arapahoe County,8005
3738,5189,9144,0.408792651,0.567475941,1451,0.15868329,CO,Archuleta County,8007
317,1867,2225,0.14247191,0.839101124,1550,0.696629213,CO,Baca County,8009
732,1503,2274,0.321899736,0.660949868,771,0.339050132,CO,Bent County,8011
159089,42501,206111,0.771860793,0.206204424,-116588,-0.56565637,CO,Boulder County,8013
29077,16295,46632,0.623541774,0.349438154,-12782,-0.27410362,CO,Broomfield County,8014
7160,6222,13717,0.521980025,0.453597725,-938,-0.068382299,CO,Chaffee County,8015
131,993,1136,0.115316901,0.874119718,862,0.758802817,CO,Cheyenne County,8017
3604,2754,6548,0.550397068,0.420586439,-850,-0.129810629,CO,Clear Creek County,8019
1959,2286,4333,0.452111701,0.527579045,327,0.075467344,CO,Conejos County,8021
1311,741,2094,0.626074499,0.353868195,-570,-0.272206304,CO,Costilla County,8023
437,1271,1750,0.249714286,0.726285714,834,0.476571429,CO,Crowley County,8025
1112,2474,3634,0.305998899,0.680792515,1362,0.374793616,CO,Custer County,8027
5887,13081,19370,0.303923593,0.675322664,7194,0.371399071,CO,Delta County,8029
313292,71617,393824,0.795512716,0.181850268,-241675,-0.613662448,CO,Denver County,8031
341,1089,1449,0.235334714,0.751552795,748,0.516218081,CO,Dolores County,8033
104653,121270,231599,0.451871554,0.523620568,16617,0.071749014,CO,Douglas County,8035
18588,9892,29140,0.637886067,0.339464653,-8696,-0.298421414,CO,Eagle County,8037
4490,14027,18983,0.236527419,0.738924301,9537,0.502396881,CO,Elbert County,8039
161941,202828,378849,0.427455266,0.535379531,40887,0.107924265,CO,El Paso County,8041
7369,17517,25557,0.288335877,0.685409086,10148,0.397073209,CO,Fremont County,8043
15427,14717,30904,0.499191043,0.476216671,-710,-0.022974372,CO,Garfield County,8045
2223,1833,4186,0.531055901,0.437888199,-390,-0.093167702,CO,Gilpin County,8047
4710,4883,9870,0.477203647,0.49473151,173,0.017527862,CO,Grand County,8049
6976,3599,10887,0.640764214,0.330577753,-3377,-0.310186461,CO,Gunnison County,8051
255,353,632,0.403481013,0.558544304,98,0.155063291,CO,Hinsdale County,8053
2076,2203,4406,0.47117567,0.5,127,0.02882433,CO,Huerfano County,8055
175,681,876,0.199771689,0.77739726,506,0.577625571,CO,Jackson County,8057
218396,148417,377357,0.578751686,0.393306604,-69979,-0.185445083,CO,Jefferson County,8059
98,795,903,0.108527132,0.880398671,697,0.771871539,CO,Kiowa County,8061
662,3144,3871,0.171015242,0.812193232,2482,0.64117799,CO,Kit Carson County,8063
2303,1497,3961,0.581418834,0.377934865,-806,-0.203483969,CO,Lake County,8065
20548,14233,35667,0.576106765,0.399052345,-6315,-0.17705442,CO,La Plata County,8067
126120,91489,224338,0.562187414,0.407817668,-34631,-0.154369746,CO,Larimer County,8069
3497,4284,7961,0.439266424,0.538123351,787,0.098856928,CO,Las Animas County,8071
470,2135,2651,0.177291588,0.805356469,1665,0.628064881,CO,Lincoln County,8073
2218,8087,10532,0.210596278,0.767850361,5869,0.557254083,CO,Logan County,8075
31536,56894,90622,0.347994968,0.627816645,25358,0.279821677,CO,Mesa County,8077
317,427,756,0.419312169,0.564814815,110,0.145502646,CO,Mineral County,8079
1203,5670,7026,0.171221178,0.807002562,4467,0.635781383,CO,Moffat County,8081
5836,9306,15500,0.376516129,0.600387097,3470,0.223870968,CO,Montezuma County,8083
7687,16770,24922,0.30844234,0.672899446,9083,0.364457106,CO,Montrose County,8085
3876,9593,13744,0.28201397,0.697977299,5717,0.415963329,CO,Morgan County,8087
3605,5756,9576,0.376461988,0.601086048,2151,0.22462406,CO,Otero County,8089
2365,1577,4020,0.588308458,0.392288557,-788,-0.1960199,CO,Ouray County,8091
4903,6991,12290,0.398942229,0.568836452,2088,0.169894223,CO,Park County,8093
486,1958,2485,0.195573441,0.787927565,1472,0.592354125,CO,Phillips County,8095
8989,2780,11957,0.751777202,0.232499791,-6209,-0.519277411,CO,Pitkin County,8097
1458,4008,5561,0.262183061,0.720733681,2550,0.45855062,CO,Prowers County,8099
43772,42252,88299,0.495724753,0.478510515,-1520,-0.017214238,CO,Pueblo County,8101
561,3061,3691,0.15199133,0.829314549,2500,0.677323219,CO,Rio Blanco County,8103
2495,3660,6305,0.395717684,0.580491673,1165,0.184773989,CO,Rio Grande County,8105
10582,5925,16876,0.627044323,0.351090306,-4657,-0.275954018,CO,Routt County,8107
1884,1413,3389,0.555916199,0.41693715,-471,-0.13897905,CO,Saguache County,8109
342,202,563,0.607460036,0.358792185,-140,-0.248667851,CO,San Juan County,8111
3924,1136,5147,0.762385856,0.220711094,-2788,-0.541674762,CO,San Miguel County,8113
301,1121,1446,0.208160443,0.775242047,820,0.567081604,CO,Sedgwick County,8115
12620,5319,18465,0.683455185,0.288058489,-7301,-0.395396696,CO,Summit County,8117
5278,11241,16939,0.311588642,0.663616506,5963,0.352027865,CO,Teller County,8119
369,2595,3008,0.122672872,0.862699468,2226,0.740026596,CO,Washington County,8121
66060,96145,166968,0.395644674,0.575828901,30085,0.180184227,CO,Weld County,8123
785,4107,4981,0.157598876,0.824533226,3322,0.666934351,CO,Yuma County,8125
297505,169039,473005,0.628967981,0.357372544,-128466,-0.271595438,CT,Fairfield County,9001
283368,159024,449335,0.63063861,0.353909667,-124344,-0.276728944,CT,Hartford County,9003
50164,55601,107549,0.466429256,0.516982957,5437,0.050553701,CT,Litchfield County,9005
56848,40665,99198,0.57307607,0.4099377,-16183,-0.16313837,CT,Middlesex County,9007
242629,169892,418003,0.580447987,0.406437274,-72737,-0.174010713,CT,New Haven County,9009
79459,57110,139604,0.569174236,0.4090857,-22349,-0.160088536,CT,New London County,9011
44006,34819,80546,0.546346187,0.43228714,-9187,-0.114059047,CT,Tolland County,9013
26701,29141,57077,0.467806647,0.510555916,2440,0.042749269,CT,Windham County,9015
44552,41009,87025,0.511944843,0.471232404,-3543,-0.040712439,DE,Kent County,10001
195034,88364,287633,0.678065451,0.307210925,-106670,-0.370854526,DE,New Castle County,10003
56682,71230,129352,0.438199641,0.550667945,14548,0.112468304,DE,Sussex County,10005
317323,18586,344356,0.921496939,0.053973214,-298737,-0.867523725,DC,District of Columbia,11001
89704,50972,142604,0.629042664,0.357437379,-38732,-0.271605285,FL,Alachua County,12001
2037,11911,14059,0.144889395,0.847215307,9874,0.702325912,FL,Baker County,12003
25614,66097,93024,0.275348297,0.710537066,40483,0.435188768,FL,Bay County,12005
3160,10334,13632,0.231807512,0.758069249,7174,0.526261737,FL,Bradford County,12007
148549,207883,360764,0.41176226,0.57622989,59334,0.16446763,FL,Brevard County,12009
618752,333409,957672,0.646100126,0.348145294,-285343,-0.297954832,FL,Broward County,12011
1209,5274,6526,0.185258964,0.808152007,4065,0.622893043,FL,Calhoun County,12013
42273,73243,116340,0.363357401,0.629559911,30970,0.26620251,FL,Charlotte County,12015
27092,65352,93208,0.290661746,0.701141533,38260,0.410479787,FL,Citrus County,12017
38317,84480,124405,0.30800209,0.679072385,46163,0.371070295,FL,Clay County,12019
77621,128950,207818,0.373504701,0.620494856,51329,0.246990155,FL,Collier County,12021
8914,23836,33042,0.269777858,0.721384904,14922,0.451607046,FL,Columbia County,12023
4259,8313,12659,0.336440477,0.656686942,4054,0.320246465,FL,DeSoto County,12027
1365,6759,8167,0.167136035,0.827598874,5394,0.660462838,FL,Dixie County,12029
252556,233762,492820,0.512471085,0.474335457,-18794,-0.038135628,FL,Duval County,12031
70929,96674,170372,0.416318409,0.56742892,25745,0.151110511,FL,Escambia County,12033
28161,43043,71716,0.39267388,0.600186848,14882,0.207512968,FL,Flagler County,12035
2120,4675,6849,0.309534239,0.682581399,2555,0.37304716,FL,Franklin County,12037
16153,7465,23762,0.679782847,0.314157057,-8688,-0.365625789,FL,Gadsden County,12039
1700,7895,9685,0.175529169,0.81517811,6195,0.639648942,FL,Gilchrist County,12041
1385,3782,5193,0.26670518,0.72828808,2397,0.4615829,FL,Glades County,12043
1985,6113,8163,0.243170403,0.748866838,4128,0.505696435,FL,Gulf County,12045
1963,3815,5830,0.33670669,0.654373928,1852,0.317667238,FL,Hamilton County,12047
2298,6122,8485,0.270830878,0.721508544,3824,0.450677666,FL,Hardee County,12049
4929,7906,12940,0.380911901,0.610973725,2977,0.230061824,FL,Hendry County,12051
37519,70412,108922,0.344457502,0.646444245,32893,0.301986743,FL,Hernando County,12053
16938,34873,52170,0.32466935,0.6684493,17935,0.34377995,FL,Highlands County,12055
376367,327398,712063,0.528558569,0.459787968,-48969,-0.0687706,FL,Hillsborough County,12057
924,8080,9068,0.10189678,0.891045434,7156,0.789148655,FL,Holmes County,12059
37844,58872,97484,0.388207296,0.603914489,21028,0.215707193,FL,Indian River County,12061
6766,15488,22419,0.301797582,0.690842589,8722,0.389045006,FL,Jackson County,12063
3897,4479,8451,0.46112886,0.52999645,582,0.06886759,FL,Jefferson County,12065
510,3128,3658,0.139420448,0.855112083,2618,0.715691635,FL,Lafayette County,12067
83505,125859,211314,0.395170221,0.595601806,42354,0.200431585,FL,Lake County,12069
157695,233247,393899,0.400343743,0.592149257,75552,0.191805514,FL,Lee County,12071
103517,57453,162929,0.635350367,0.35262599,-46064,-0.282724377,FL,Leon County,12073
6205,16749,23145,0.268092461,0.723655217,10544,0.455562757,FL,Levy County,12075
694,2846,3561,0.194889076,0.799213704,2152,0.604324628,FL,Liberty County,12077
3747,5576,9380,0.399466951,0.59445629,1829,0.194989339,FL,Madison County,12079
90166,124987,216958,0.415591958,0.57608846,34821,0.160496502,FL,Manatee County,12081
74858,127826,204376,0.366275884,0.625445258,52968,0.259169374,FL,Marion County,12083
36893,61168,98726,0.373690821,0.619573365,24275,0.245882544,FL,Martin County,12085
617864,532833,1156816,0.534107412,0.460603069,-85031,-0.073504343,FL,Miami-Dade County,12086
21881,25693,48029,0.455578921,0.534947636,3812,0.079368715,FL,Monroe County,12087
15564,42566,58811,0.264644369,0.723776164,27002,0.459131795,FL,Nassau County,12089
34248,79798,116373,0.294295068,0.685708884,45550,0.391413816,FL,Okaloosa County,12091
4390,11470,15954,0.275166103,0.718941958,7080,0.443775856,FL,Okeechobee County,12093
395014,245398,647403,0.610151637,0.379049834,-149616,-0.231101802,FL,Orange County,12095
97297,73480,172436,0.564249925,0.426129115,-23817,-0.13812081,FL,Osceola County,12097
433572,334711,773158,0.560780591,0.4329141,-98861,-0.12786649,FL,Palm Beach County,12099
119073,179621,301970,0.394320628,0.594830612,60548,0.200509984,FL,Pasco County,12101
277450,276209,559715,0.495698704,0.493481504,-1241,-0.0022172,FL,Pinellas County,12103
145049,194586,343256,0.422567996,0.566883026,49537,0.14431503,FL,Polk County,12105
10527,25514,36373,0.289417975,0.701454375,14987,0.412036401,FL,Putnam County,12107
63850,110946,176622,0.361506494,0.628155043,47096,0.266648549,FL,St. Johns County,12109
84137,86831,172169,0.48868844,0.504335856,2694,0.015647416,FL,St. Lucie County,12111
27612,77385,106928,0.258229837,0.723711282,49773,0.465481445,FL,Santa Rosa County,12113
120110,148370,270575,0.443906495,0.548350735,28260,0.104444239,FL,Sarasota County,12115
132528,125241,260815,0.508130284,0.48019094,-7287,-0.027939344,FL,Seminole County,12117
29341,62761,92485,0.317251446,0.678607342,33420,0.361355896,FL,Sumter County,12119
4485,16410,21057,0.212993304,0.779313292,11925,0.566319989,FL,Suwannee County,12121
2299,7751,10127,0.227016886,0.765379678,5452,0.538362793,FL,Taylor County,12123
1053,5133,6245,0.168614892,0.82193755,4080,0.653322658,FL,Union County,12125
130575,173821,307439,0.424718399,0.565383702,43246,0.140665303,FL,Volusia County,12127
5351,12874,18404,0.29075201,0.699521843,7523,0.408769833,FL,Wakulla County,12129
10338,32947,43711,0.236507973,0.753746197,22609,0.517238224,FL,Walton County,12131
2347,9876,12327,0.190395068,0.801168167,7529,0.6107731,FL,Washington County,12133
1779,6526,8341,0.213283779,0.782400192,4747,0.569116413,GA,Appling County,13001
825,2300,3155,0.261489699,0.729001585,1475,0.467511886,GA,Atkinson County,13003
625,4018,4668,0.133890317,0.86075407,3393,0.726863753,GA,Bacon County,13005
652,897,1555,0.419292605,0.576848875,245,0.15755627,GA,Baker County,13007
9140,8903,18251,0.500794477,0.487808887,-237,-0.01298559,GA,Baldwin County,13009
932,7795,8801,0.105897057,0.885694807,6863,0.77979775,GA,Banks County,13011
10453,26804,37921,0.275652013,0.7068379,16351,0.431185886,GA,Barrow County,13013
12092,37674,50467,0.239602116,0.746507619,25582,0.506905503,GA,Bartow County,13015
2392,4110,6560,0.364634146,0.62652439,1718,0.261890244,GA,Ben Hill County,13017
1269,6419,7743,0.163889965,0.829006845,5150,0.66511688,GA,Berrien County,13019
43468,26585,70802,0.613937459,0.375483743,-16883,-0.238453716,GA,Bibb County,13021
1311,4328,5706,0.229758149,0.758499825,3017,0.528741675,GA,Bleckley County,13023
699,6991,7746,0.090240124,0.902530338,6292,0.812290214,GA,Brantley County,13025
2790,4260,7100,0.392957746,0.6,1470,0.207042254,GA,Brooks County,13027
6739,14244,21340,0.31579194,0.667478913,7505,0.351686973,GA,Bryan County,13029
11243,18386,30084,0.37372025,0.611155431,7143,0.237435181,GA,Bulloch County,13031
5209,5400,10684,0.487551479,0.505428678,191,0.0178772,GA,Burke County,13033
3274,8406,11786,0.277787205,0.713219073,5132,0.435431868,GA,Butts County,13035
1260,923,2194,0.574293528,0.420692799,-337,-0.153600729,GA,Calhoun County,13037
7967,15251,23688,0.336330632,0.643828099,7284,0.307497467,GA,Camden County,13039
1269,3133,4431,0.286391334,0.707063868,1864,0.420672534,GA,Candler County,13043
16238,37476,54474,0.298087161,0.687961229,21238,0.389874068,GA,Carroll County,13045
6932,25167,32651,0.212305902,0.770788031,18235,0.558482129,GA,Catoosa County,13047
1103,3419,4566,0.241568112,0.748795445,2316,0.507227332,GA,Charlton County,13049
78254,53237,133420,0.58652376,0.399018138,-25017,-0.187505621,GA,Chatham County,13051
667,880,1582,0.421618205,0.556257901,213,0.134639697,GA,Chattahoochee County,13053
1854,8064,10050,0.184477612,0.80238806,6210,0.617910448,GA,Chattooga County,13055
42794,99587,144830,0.295477456,0.687613064,56793,0.392135607,GA,Cherokee County,13057
36048,14446,51333,0.702238326,0.281417412,-21602,-0.420820914,GA,Clarke County,13059
790,637,1434,0.550906555,0.444211994,-153,-0.106694561,GA,Clay County,13061
95476,15813,112344,0.84985402,0.140755181,-79663,-0.709098839,GA,Clayton County,13063
747,2105,2864,0.260824022,0.734986034,1358,0.474162011,GA,Clinch County,13065
221846,165459,393746,0.563424136,0.420217602,-56387,-0.143206534,GA,Cobb County,13067
4511,10578,15214,0.296503221,0.695280663,6067,0.398777442,GA,Coffee County,13069
4187,11777,16083,0.260337002,0.732263881,7590,0.471926879,GA,Colquitt County,13071
29236,50013,80579,0.362824061,0.620670398,20777,0.257846337,GA,Columbia County,13073
2059,4900,7035,0.29267946,0.696517413,2841,0.403837953,GA,Cook County,13075
24210,51501,76799,0.31523848,0.670594669,27291,0.35535619,GA,Coweta County,13077
1615,4428,6102,0.264667322,0.725663717,2813,0.460996395,GA,Crawford County,13079
2986,4987,8050,0.370931677,0.619503106,2001,0.248571429,GA,Crisp County,13081
1261,6066,7434,0.169626043,0.81598063,4805,0.646354587,GA,Dade County,13083
2486,13398,16081,0.154592376,0.833157142,10912,0.678564766,GA,Dawson County,13085
4780,6758,11627,0.411112067,0.581233336,1978,0.170121269,GA,Decatur County,13087
308227,58373,370804,0.831239685,0.157422789,-249854,-0.673816895,GA,DeKalb County,13089
2171,5843,8070,0.269021066,0.724039653,3672,0.455018587,GA,Dodge County,13091
1911,2159,4105,0.465529842,0.525943971,248,0.060414129,GA,Dooly County,13093
24577,10454,35311,0.696015406,0.296055054,-14123,-0.399960352,GA,Dougherty County,13095
42809,25451,69097,0.619549329,0.368337265,-17358,-0.251212064,GA,Douglas County,13097
2437,2722,5187,0.469828417,0.524773472,285,0.054945055,GA,Early County,13099
167,1256,1441,0.115891742,0.871616933,1089,0.755725191,GA,Echols County,13101
7720,23358,31570,0.244535952,0.739879633,15638,0.495343681,GA,Effingham County,13103
2879,6226,9171,0.313924327,0.678879075,3347,0.364954749,GA,Elbert County,13105
2884,6551,9501,0.303546995,0.689506368,3667,0.385959373,GA,Emanuel County,13107
1324,2888,4247,0.31174947,0.680009418,1564,0.368259948,GA,Evans County,13109
2571,12169,14850,0.173131313,0.819461279,9598,0.646329966,GA,Fannin County,13111
33065,37952,71993,0.459280763,0.527162363,4887,0.0678816,GA,Fayette County,13113
12008,29123,41648,0.288321168,0.699265271,17115,0.410944103,GA,Floyd County,13115
42203,85122,129305,0.326383357,0.65830401,42919,0.331920653,GA,Forsyth County,13117
1593,9069,10765,0.147979563,0.842452392,7476,0.694472829,GA,Franklin County,13119
381144,137240,524659,0.726460425,0.261579426,-243904,-0.464880999,GA,Fulton County,13121
2932,13429,16525,0.177428139,0.812647504,10497,0.635219365,GA,Gilmer County,13123
155,1403,1566,0.098978289,0.895913155,1248,0.796934866,GA,Glascock County,13125
15879,25616,41984,0.378215511,0.610137195,9737,0.231921684,GA,Glynn County,13127
4384,19405,24033,0.182415845,0.807431448,15021,0.625015604,GA,Gordon County,13129
3619,7034,10707,0.338003175,0.656953395,3415,0.318950219,GA,Grady County,13131
4088,7068,11247,0.363474704,0.628434249,2980,0.264959545,GA,Greene County,13133
241827,166413,413865,0.584313725,0.402094886,-75414,-0.182218839,GA,Gwinnett County,13135
3563,16637,20432,0.17438332,0.814261942,13074,0.639878622,GA,Habersham County,13137
25031,64170,90523,0.276515361,0.708880616,39139,0.432365255,GA,Hall County,13139
2985,1159,4165,0.716686675,0.278271309,-1826,-0.438415366,GA,Hancock County,13141
1792,12331,14248,0.125772038,0.865454801,10539,0.739682762,GA,Haralson County,13143
5457,14319,19991,0.272972838,0.716272323,8862,0.443299485,GA,Harris County,13145
3157,9464,12727,0.248055315,0.743615935,6307,0.495560619,GA,Hart County,13147
824,4516,5391,0.152847338,0.83769245,3692,0.684845112,GA,Heard County,13149
73276,48187,122742,0.596992065,0.392587704,-25089,-0.20440436,GA,Henry County,13151
32232,41534,74823,0.430776633,0.555096695,9302,0.124320062,GA,Houston County,13153
1008,3134,4168,0.24184261,0.751919386,2126,0.510076775,GA,Irwin County,13155
7642,29497,37670,0.202867003,0.783036899,21855,0.580169896,GA,Jackson County,13157
1761,5822,7644,0.230376766,0.761643119,4061,0.531266353,GA,Jasper County,13159
1028,4695,5771,0.17813204,0.813550511,3667,0.635418472,GA,Jeff Davis County,13161
4061,3537,7642,0.531405391,0.462836954,-524,-0.068568438,GA,Jefferson County,13163
1266,2161,3455,0.36642547,0.625470333,895,0.259044863,GA,Jenkins County,13165
1222,2850,4100,0.29804878,0.695121951,1628,0.397073171,GA,Johnson County,13167
4888,9965,14966,0.326606976,0.665842577,5077,0.339235601,GA,Jones County,13169
2615,6330,9039,0.289301914,0.700298706,3715,0.410996792,GA,Lamar County,13171
1019,2509,3576,0.284955257,0.701621924,1490,0.416666667,GA,Lanier County,13173
8073,14493,22729,0.355185006,0.637643539,6420,0.282458533,GA,Laurens County,13175
4558,12007,16714,0.272705516,0.718379801,7449,0.445674285,GA,Lee County,13177
13099,7959,21389,0.612417598,0.372107158,-5140,-0.24031044,GA,Liberty County,13179
1435,3179,4650,0.308602151,0.683655914,1744,0.375053763,GA,Lincoln County,13181
2033,3528,5656,0.359441301,0.623762376,1495,0.264321075,GA,Long County,13183
20117,25691,46355,0.433976917,0.554222845,5574,0.120245928,GA,Lowndes County,13185
3126,12163,15531,0.20127487,0.783143391,9037,0.581868521,GA,Lumpkin County,13187
4168,6169,10455,0.398660928,0.590052606,2001,0.191391679,GA,McDuffie County,13189
2612,4016,6696,0.390083632,0.599761051,1404,0.209677419,GA,McIntosh County,13191
2857,1783,4662,0.612827113,0.382453882,-1074,-0.23037323,GA,Macon County,13193
3411,11326,14937,0.228359108,0.758251322,7915,0.529892214,GA,Madison County,13195
1311,2275,3624,0.361754967,0.627759382,964,0.266004415,GA,Marion County,13197
4287,6524,10877,0.394134412,0.599797738,2237,0.205663326,GA,Meriwether County,13199
749,2066,2835,0.264197531,0.728747795,1317,0.464550265,GA,Miller County,13201
3995,4935,8963,0.445721299,0.550596898,940,0.1048756,GA,Mitchell County,13205
4384,11060,15592,0.281169831,0.709338122,6676,0.428168291,GA,Monroe County,13207
979,2960,3966,0.24684821,0.746343923,1981,0.499495714,GA,Montgomery County,13209
3355,8230,11707,0.286580678,0.702998206,4875,0.416417528,GA,Morgan County,13211
2302,12943,15389,0.149587368,0.841055299,10641,0.691467932,GA,Murray County,13213
49529,30049,80543,0.614938604,0.373080218,-19480,-0.241858386,GA,Muscogee County,13215
29794,23869,54239,0.549309537,0.440070798,-5925,-0.10923874,GA,Newton County,13217
8162,16595,25168,0.324300699,0.65936904,8433,0.335068341,GA,Oconee County,13219
2436,5593,8131,0.299594146,0.687861272,3157,0.388267126,GA,Oglethorpe County,13221
29704,54525,85385,0.347883118,0.638578205,24821,0.290695087,GA,Paulding County,13223
5920,6502,12545,0.471901156,0.518294141,582,0.046392985,GA,Peach County,13225
2808,14075,17116,0.164057023,0.822329984,11267,0.658272961,GA,Pickens County,13227
1100,7899,9048,0.121573828,0.87301061,6799,0.751436782,GA,Pierce County,13229
1505,9127,10720,0.140391791,0.851399254,7622,0.711007463,GA,Pike County,13231
3658,13589,17399,0.210241968,0.781021898,9931,0.57077993,GA,Polk County,13233
1217,2805,4059,0.299827544,0.691056911,1588,0.391229367,GA,Pulaski County,13235
3448,8291,11855,0.290847744,0.699367356,4843,0.408519612,GA,Putnam County,13237
497,604,1106,0.449367089,0.546112116,107,0.096745027,GA,Quitman County,13239
1984,7474,9568,0.20735786,0.781145485,5490,0.573787625,GA,Rabun County,13241
1671,1391,3074,0.543591412,0.45250488,-280,-0.091086532,GA,Randolph County,13243
59124,26781,87016,0.679461249,0.307770985,-32343,-0.371690264,GA,Richmond County,13245
31244,13012,44686,0.699189903,0.291187397,-18232,-0.408002506,GA,Rockdale County,13247
462,1800,2275,0.203076923,0.791208791,1338,0.588131868,GA,Schley County,13249
2661,3916,6628,0.401478576,0.590826795,1255,0.18934822,GA,Screven County,13251
1254,2611,3884,0.322863028,0.672245108,1357,0.34938208,GA,Seminole County,13253
11784,18057,30116,0.391287024,0.599581618,6273,0.208294594,GA,Spalding County,13255
2385,9368,11885,0.200673117,0.788220446,6983,0.587547329,GA,Stephens County,13257
1182,801,1990,0.593969849,0.402512563,-381,-0.191457286,GA,Stewart County,13259
6318,5732,12150,0.52,0.471769547,-586,-0.048230453,GA,Sumter County,13261
2114,1392,3522,0.600227144,0.395229983,-722,-0.204997161,GA,Talbot County,13263
561,360,928,0.604525862,0.387931034,-201,-0.216594828,GA,Taliaferro County,13265
2061,6053,8183,0.25186362,0.739704265,3992,0.487840645,GA,Tattnall County,13267
1387,2418,3839,0.361292003,0.629851524,1031,0.268559521,GA,Taylor County,13269
1487,2825,4333,0.343180245,0.651973229,1338,0.308792984,GA,Telfair County,13271
2376,2004,4416,0.538043478,0.453804348,-372,-0.08423913,GA,Terrell County,13273
8708,12954,21853,0.398480758,0.592779023,4246,0.194298266,GA,Thomas County,13275
5322,10784,16283,0.326843948,0.66228582,5462,0.335441872,GA,Tift County,13277
2939,7872,10914,0.269287154,0.721275426,4933,0.451988272,GA,Toombs County,13279
1550,6384,7979,0.194259932,0.800100263,4834,0.605840331,GA,Towns County,13281
952,2101,3077,0.309392265,0.68280793,1149,0.373415665,GA,Treutlen County,13283
11578,18143,30049,0.385304003,0.603780492,6565,0.218476488,GA,Troup County,13285
1410,2349,3792,0.371835443,0.619462025,939,0.247626582,GA,Turner County,13287
2044,2370,4444,0.459945995,0.53330333,326,0.073357336,GA,Twiggs County,13289
2801,12651,15560,0.180012853,0.813046272,9850,0.633033419,GA,Union County,13291
4201,8608,12905,0.325532739,0.667028284,4407,0.341495544,GA,Upson County,13293
5769,23174,29354,0.196531989,0.789466512,17405,0.592934523,GA,Walker County,13295
12682,37842,51095,0.248204325,0.740620413,25160,0.492416088,GA,Walton County,13297
4211,9865,14192,0.29671646,0.695109921,5654,0.398393461,GA,Ware County,13299
1469,1166,2651,0.554130517,0.439834025,-303,-0.114296492,GA,Warren County,13301
4730,4663,9459,0.50005286,0.492969659,-67,-0.007083201,GA,Washington County,13303
2687,9987,12778,0.210283299,0.781577712,7300,0.571294412,GA,Wayne County,13305
639,748,1390,0.45971223,0.538129496,109,0.078417266,GA,Webster County,13307
689,1583,2285,0.301531729,0.692778993,894,0.391247265,GA,Wheeler County,13309
2411,12222,14816,0.162729482,0.824919006,9811,0.662189525,GA,White County,13311
10670,25636,36746,0.290371741,0.697654166,14966,0.407282425,GA,Whitfield County,13313
862,2403,3281,0.262724779,0.732398659,1541,0.46967388,GA,Wilcox County,13315
2160,2823,5029,0.429508849,0.561344204,663,0.131835355,GA,Wilkes County,13317
2075,2664,4770,0.435010482,0.558490566,589,0.123480084,GA,Wilkinson County,13319
2395,6830,9285,0.257942919,0.735595046,4435,0.477652127,GA,Worth County,13321
58731,26897,87814,0.668811351,0.306295124,-31834,-0.362516227,HI,Hawaii County,15001
238869,136259,382114,0.625124963,0.356592535,-102610,-0.268532427,HI,Honolulu County,15003
21225,11582,33497,0.633638833,0.345762307,-9643,-0.287876526,HI,Kauai County,15007
47305,22126,71044,0.665854963,0.311440797,-25179,-0.354414166,HI,Maui County,15009
120539,130699,259389,0.464703592,0.503872562,10160,0.03916897,ID,Ada County,16001
591,1941,2586,0.228538283,0.750580046,1350,0.522041763,ID,Adams County,16003
14682,23331,39553,0.371198139,0.589866761,8649,0.218668622,ID,Bannock County,16005
350,2914,3315,0.105580694,0.879034691,2564,0.773453997,ID,Bear Lake County,16007
977,3878,4973,0.196460889,0.779810979,2901,0.58335009,ID,Benewah County,16009
4124,15295,20094,0.205235394,0.761172489,11171,0.555937096,ID,Bingham County,16011
8919,4031,13288,0.671207104,0.303356412,-4888,-0.367850692,ID,Blaine County,16013
1204,3485,4820,0.249792531,0.723029046,2281,0.473236515,ID,Boise County,16015
8310,18369,27352,0.303816906,0.671577947,10059,0.367761041,ID,Bonner County,16017
14254,37805,53995,0.263987406,0.700157422,23551,0.436170016,ID,Bonneville County,16019
1220,4937,6313,0.19325202,0.782037066,3717,0.588785047,ID,Boundary County,16021
188,1202,1415,0.132862191,0.849469965,1014,0.716607774,ID,Butte County,16023
149,507,754,0.197612732,0.672413793,358,0.474801061,ID,Camas County,16025
25881,61759,90438,0.286173953,0.682887724,35878,0.396713771,ID,Canyon County,16027
431,2906,3416,0.12617096,0.850702576,2475,0.724531616,ID,Caribou County,16029
1464,7907,9629,0.15204071,0.82116523,6443,0.66912452,ID,Cassia County,16031
41,264,311,0.131832797,0.848874598,223,0.717041801,ID,Clark County,16033
877,3453,4419,0.19846119,0.781398506,2576,0.582937316,ID,Clearwater County,16035
603,2089,2739,0.220153341,0.762687112,1486,0.542533771,ID,Custer County,16037
2601,7246,10205,0.254875061,0.710044096,4645,0.455169035,ID,Elmore County,16039
657,5845,6664,0.098589436,0.87710084,5188,0.778511405,ID,Franklin County,16041
998,5548,6719,0.148534008,0.825718113,4550,0.677184105,ID,Fremont County,16043
1803,7951,9958,0.181060454,0.798453505,6148,0.617393051,ID,Gem County,16045
1256,4659,6050,0.207603306,0.770082645,3403,0.562479339,ID,Gooding County,16047
1561,7826,9602,0.162570298,0.815038534,6265,0.652468236,ID,Idaho County,16049
1661,12099,14173,0.117194666,0.85366542,10438,0.736470754,ID,Jefferson County,16051
1893,5734,7812,0.242319508,0.733998976,3841,0.491679467,ID,Jerome County,16053
24312,62837,89878,0.270500011,0.699136607,38525,0.428636596,ID,Kootenai County,16055
10236,9472,20570,0.49761789,0.460476422,-764,-0.037141468,ID,Latah County,16057
1032,3592,4738,0.217813423,0.758125791,2560,0.540312368,ID,Lemhi County,16059
349,1489,1870,0.186631016,0.796256684,1140,0.609625668,ID,Lewis County,16061
414,1469,1940,0.213402062,0.757216495,1055,0.543814433,ID,Lincoln County,16063
2666,13559,17112,0.155797101,0.792367929,10893,0.636570827,ID,Madison County,16065
1550,6265,7993,0.19391968,0.783810834,4715,0.589891155,ID,Minidoka County,16067
6686,13738,20967,0.318882053,0.655220108,7052,0.336338055,ID,Nez Perce County,16069
249,2148,2451,0.101591187,0.876376989,1899,0.774785802,ID,Oneida County,16071
816,3819,4742,0.172079291,0.80535639,3003,0.633277098,ID,Owyhee County,16073
2161,8862,11293,0.191357478,0.784733906,6701,0.593376428,ID,Payette County,16075
865,2116,3086,0.280298121,0.685677252,1251,0.405379132,ID,Power County,16077
1693,4216,6049,0.279880972,0.696974707,2523,0.417093735,ID,Shoshone County,16079
3318,2858,6347,0.522766661,0.450291476,-460,-0.072475185,ID,Teton County,16081
9391,25897,36680,0.256025082,0.706025082,16506,0.45,ID,Twin Falls County,16083
2976,3947,7063,0.421350701,0.558827694,971,0.137476993,ID,Valley County,16085
1073,4154,5344,0.200785928,0.777320359,3081,0.576534431,ID,Washington County,16087
8569,24131,33434,0.256295986,0.721750314,15562,0.465454328,IL,Adams County,17001
1114,1486,2625,0.424380952,0.566095238,372,0.141714286,IL,Alexander County,17003
2275,5612,8109,0.280552473,0.692070539,3337,0.411518066,IL,Bond County,17005
10372,13762,24672,0.42039559,0.557798314,3390,0.137402724,IL,Boone County,17007
485,1930,2523,0.19223147,0.764962346,1445,0.572730876,IL,Brown County,17009
6545,10296,17182,0.380921895,0.599231754,3751,0.218309859,IL,Bureau County,17011
674,2043,2767,0.24358511,0.738344778,1369,0.494759668,IL,Calhoun County,17013
2737,5098,8006,0.341868599,0.636772421,2361,0.294903822,IL,Carroll County,17015
1615,3624,5325,0.303286385,0.68056338,2009,0.377276995,IL,Cass County,17017
56596,35122,94911,0.596306013,0.370051943,-21474,-0.22625407,IL,Champaign County,17019
4286,11505,16094,0.266310426,0.714862682,7219,0.448552255,IL,Christian County,17021
1990,6215,8340,0.238609113,0.745203837,4225,0.506594724,IL,Clark County,17023
1129,5626,6896,0.163718097,0.815835267,4497,0.652117169,IL,Clay County,17025
4459,14264,19139,0.23297978,0.745284498,9805,0.512304718,IL,Clinton County,17027
7997,13981,22470,0.355896751,0.622207388,5984,0.266310636,IL,Coles County,17029
1725973,558269,2321399,0.743505533,0.240488171,-1167704,-0.503017362,IL,Cook County,17031
2198,7025,9419,0.233358106,0.745832891,4827,0.512474785,IL,Crawford County,17033
1141,4595,5843,0.195276399,0.78641109,3454,0.591134691,IL,Cumberland County,17035
24643,21905,47989,0.513513514,0.456458772,-2738,-0.057054742,IL,DeKalb County,17037
2171,5623,7994,0.271578684,0.703402552,3452,0.431823868,IL,De Witt County,17039
2327,6221,8746,0.266064487,0.711296593,3894,0.445232106,IL,Douglas County,17041
281222,193611,485064,0.57976267,0.399145267,-87611,-0.180617403,IL,DuPage County,17043
1869,6169,8152,0.229268891,0.756746811,4300,0.52747792,IL,Edgar County,17045
488,2833,3368,0.144893112,0.841152019,2345,0.696258907,IL,Edwards County,17047
3700,14983,19041,0.194317525,0.786880941,11283,0.592563416,IL,Effingham County,17049
1815,8025,10033,0.18090302,0.79986046,6210,0.61895744,IL,Fayette County,17051
1691,4956,6809,0.248347775,0.727860185,3265,0.47951241,IL,Ford County,17053
4690,13514,18488,0.253678061,0.730960623,8824,0.477282562,IL,Franklin County,17055
6371,9798,16517,0.3857238,0.593206999,3427,0.207483199,IL,Fulton County,17057
621,2019,2673,0.232323232,0.755331089,1398,0.523007856,IL,Gallatin County,17059
1349,4767,6224,0.216741645,0.76590617,3418,0.549164524,IL,Greene County,17061
9445,16372,26400,0.357765152,0.620151515,6927,0.262386364,IL,Grundy County,17063
821,3429,4316,0.190222428,0.794485635,2608,0.604263207,IL,Hamilton County,17065
1114,5309,6565,0.169687738,0.808682407,4195,0.638994669,IL,Hancock County,17067
0,0,0,0,0,0,0,IL,Hardin County,17069
1186,2391,3652,0.32475356,0.654709748,1205,0.329956188,IL,Henderson County,17071
9762,15266,25624,0.380970965,0.595769591,5504,0.214798626,IL,Henry County,17073
2895,10858,14011,0.206623367,0.774962529,7963,0.568339162,IL,Iroquois County,17075
11104,10835,22575,0.491871539,0.479955703,-269,-0.011915836,IL,Jackson County,17077
1006,4492,5582,0.180222143,0.804729488,3486,0.624507345,IL,Jasper County,17079
4597,12461,17409,0.26405882,0.715779195,7864,0.451720375,IL,Jefferson County,17081
2956,8699,11942,0.247529727,0.728437448,5743,0.480907721,IL,Jersey County,17083
5097,7161,12477,0.408511661,0.573936042,2064,0.165424381,IL,Jo Daviess County,17085
1280,5052,6442,0.198696057,0.7842285,3772,0.585532443,IL,Johnson County,17087
130166,96775,231876,0.561360382,0.417356691,-33391,-0.144003692,IL,Kane County,17089
20112,28410,49729,0.404432022,0.571296427,8298,0.166864405,IL,Kankakee County,17091
33168,29492,64205,0.516595281,0.459341173,-3676,-0.057254108,IL,Kendall County,17093
10421,11818,22716,0.458751541,0.520250044,1397,0.061498503,IL,Knox County,17095
204032,123594,334156,0.610589066,0.369869163,-80438,-0.240719903,IL,Lake County,17097
21491,29482,52053,0.412867654,0.566384262,7991,0.153516608,IL,LaSalle County,17099
1414,4849,6379,0.221664838,0.760150494,3435,0.538485656,IL,Lawrence County,17101
6368,9584,16351,0.389456302,0.58614152,3216,0.196685218,IL,Lee County,17103
4568,12134,17049,0.267933603,0.711713297,7566,0.443779694,IL,Livingston County,17105
3769,9042,13117,0.287337044,0.689334451,5273,0.401997408,IL,Logan County,17107
4973,7009,12290,0.404637917,0.570301058,2036,0.165663141,IL,McDonough County,17109
78153,82257,164574,0.474880601,0.499817711,4104,0.02493711,IL,McHenry County,17111
43719,40365,87013,0.502442164,0.463896199,-3354,-0.038545964,IL,McLean County,17113
19633,28373,48934,0.40121388,0.579821801,8740,0.178607921,IL,Macon County,17115
7313,16058,23919,0.305740207,0.671349137,8745,0.36560893,IL,Macoupin County,17117
56845,75272,135686,0.418945212,0.554751411,18427,0.1358062,IL,Madison County,17119
4396,12540,17214,0.255373533,0.728476821,8144,0.473103288,IL,Marion County,17121
2004,4196,6343,0.31593883,0.661516633,2192,0.345577802,IL,Marshall County,17123
1984,4645,6756,0.29366489,0.687537004,2661,0.393872114,IL,Mason County,17125
1719,4989,6803,0.25268264,0.733352933,3270,0.480670293,IL,Massac County,17127
2022,4764,6954,0.290767903,0.685073339,2742,0.394305436,IL,Menard County,17129
3212,5328,8750,0.367085714,0.608914286,2116,0.241828571,IL,Mercer County,17131
6489,14046,21024,0.30864726,0.668093607,7557,0.359446347,IL,Monroe County,17133
3889,9504,13701,0.283847894,0.693671995,5615,0.4098241,IL,Montgomery County,17135
5020,9903,15229,0.32963425,0.650272506,4883,0.320638256,IL,Morgan County,17137
1645,4938,6698,0.2455957,0.737234996,3293,0.491639295,IL,Moultrie County,17139
9300,16092,26040,0.357142857,0.61797235,6792,0.260829493,IL,Ogle County,17141
42600,37612,82264,0.517844987,0.457210931,-4988,-0.060634056,IL,Peoria County,17143
2609,7305,10060,0.259343936,0.726143141,4696,0.466799205,IL,Perry County,17145
3302,6219,9791,0.337248494,0.635175161,2917,0.297926667,IL,Piatt County,17147
1458,6235,7836,0.186064319,0.795686575,4777,0.609622256,IL,Pike County,17149
432,1720,2172,0.198895028,0.791896869,1288,0.593001842,IL,Pope County,17151
891,1699,2631,0.338654504,0.645762068,808,0.307107564,IL,Pulaski County,17153
1309,1978,3345,0.391330344,0.591330344,669,0.2,IL,Putnam County,17155
3590,11065,14896,0.241004296,0.742816864,7475,0.501812567,IL,Randolph County,17157
1355,7988,9343,0.145028363,0.854971637,6633,0.709943273,IL,Richland County,17159
36647,28585,66750,0.549018727,0.4282397,-8062,-0.120779026,IL,Rock Island County,17161
66698,56000,125220,0.532646542,0.447212905,-10698,-0.085433637,IL,St. Clair County,17163
2786,8096,11079,0.251466739,0.730751873,5310,0.479285134,IL,Saline County,17165
48756,53303,104395,0.467033862,0.510589588,4547,0.043555726,IL,Sangamon County,17167
1064,2767,3908,0.272262027,0.7080348,1703,0.435772774,IL,Schuyler County,17169
569,2104,2730,0.208424908,0.770695971,1535,0.562271062,IL,Scott County,17171
2488,9396,12049,0.206490165,0.779815752,6908,0.573325587,IL,Shelby County,17173
814,2000,2881,0.282540784,0.694203402,1186,0.411662617,IL,Stark County,17175
8756,12253,21446,0.408281265,0.571341975,3497,0.163060711,IL,Stephenson County,17177
24486,42194,68358,0.358202405,0.617250358,17708,0.259047953,IL,Tazewell County,17179
2575,6157,8896,0.289455935,0.692108813,3582,0.402652878,IL,Union County,17181
10313,20710,31617,0.32618528,0.655027359,10397,0.328842079,IL,Vermilion County,17183
1248,4228,5592,0.223175966,0.756080114,2980,0.532904149,IL,Wabash County,17185
3087,4671,7916,0.389969682,0.590070743,1584,0.200101061,IL,Warren County,17187
1639,6110,7914,0.207101339,0.772049532,4471,0.564948193,IL,Washington County,17189
1185,7172,8492,0.139543099,0.844559585,5987,0.705016486,IL,Wayne County,17191
1517,5788,7428,0.204227248,0.779213786,4271,0.574986537,IL,White County,17193
12195,14472,27254,0.447457254,0.531004623,2277,0.083547369,IL,Whiteside County,17195
183903,155004,346141,0.53129505,0.447805952,-28899,-0.083489098,IL,Will County,17197
10107,22681,33503,0.301674477,0.676984151,12574,0.375309674,IL,Williamson County,17199
64056,60861,127710,0.501573878,0.47655626,-3195,-0.025017618,IL,Winnebago County,17201
5976,14590,21079,0.28350491,0.692158072,8614,0.408653162,IL,Woodford County,17203
3236,10685,14238,0.227279112,0.750456525,7449,0.523177413,IN,Adams County,18001
73189,92083,169000,0.433071006,0.544869822,18894,0.111798817,IN,Allen County,18003
12934,22409,36299,0.356318356,0.61734483,9475,0.261026475,IN,Bartholomew County,18005
1009,3007,4115,0.245200486,0.730741191,1998,0.485540705,IN,Benton County,18007
1376,3838,5354,0.257004109,0.716847217,2462,0.459843108,IN,Blackford County,18009
15244,22351,38500,0.395948052,0.580545455,7107,0.184597403,IN,Boone County,18011
3036,5777,8981,0.338046988,0.643246854,2741,0.305199866,IN,Brown County,18013
2224,7086,9514,0.233760774,0.744797141,4862,0.511036367,IN,Carroll County,18015
4304,10552,15189,0.28336296,0.694713279,6248,0.411350319,IN,Cass County,18017
23088,33656,58040,0.397794624,0.579875948,10568,0.182081323,IN,Clark County,18019
2549,9498,12277,0.207624012,0.773641769,6949,0.566017757,IN,Clay County,18021
3361,9334,12961,0.259316411,0.720160481,5973,0.460844071,IN,Clinton County,18023
1369,3499,4975,0.275175879,0.703316583,2130,0.428140704,IN,Crawford County,18025
2169,9576,11971,0.181187871,0.799933172,7407,0.618745301,IN,Daviess County,18027
5446,19528,25361,0.214739166,0.770001183,14082,0.555262016,IN,Dearborn County,18029
2436,9570,12296,0.198113208,0.778301887,7134,0.580188679,IN,Decatur County,18031
4966,14237,19656,0.252645503,0.724308099,9271,0.471662597,IN,DeKalb County,18033
20474,26827,48191,0.424851113,0.556680708,6353,0.131829595,IN,Delaware County,18035
6292,15032,21805,0.28855767,0.689383169,8740,0.400825499,IN,Dubois County,18037
26108,46972,74321,0.351286985,0.632015177,20864,0.280728193,IN,Elkhart County,18039
2237,7755,10146,0.220480978,0.764340627,5518,0.543859649,IN,Fayette County,18041
17511,23400,41761,0.419314672,0.56033141,5889,0.141016738,IN,Floyd County,18043
1629,6154,7983,0.204058625,0.770888137,4525,0.566829513,IN,Fountain County,18045
2137,9691,12018,0.177816608,0.806373773,7554,0.628557164,IN,Franklin County,18047
2280,6694,9144,0.249343832,0.732064742,4414,0.48272091,IN,Fulton County,18049
4027,11817,16165,0.249118466,0.731023817,7790,0.481905351,IN,Gibson County,18051
8015,18543,27230,0.294344473,0.680976864,10528,0.386632391,IN,Grant County,18053
3389,11103,14782,0.229265323,0.751116222,7714,0.5218509,IN,Greene County,18055
88390,101587,193871,0.455921721,0.523992758,13197,0.068071037,IN,Hamilton County,18057
12895,28996,42907,0.300533712,0.675787168,16101,0.375253455,IN,Hancock County,18059
5343,14565,20231,0.264099649,0.719934754,9222,0.455835105,IN,Harrison County,18061
32604,53802,88458,0.3685817,0.608220851,21198,0.239639151,IN,Hendricks County,18063
5544,15043,21021,0.263736264,0.715617716,9499,0.451881452,IN,Henry County,18065
13270,26400,40619,0.326694404,0.649942145,13130,0.323247741,IN,Howard County,18067
4255,13147,17810,0.238910724,0.738180797,8892,0.499270073,IN,Huntington County,18069
4302,14555,19238,0.223619919,0.756575528,10253,0.532955609,IN,Jackson County,18071
3798,11383,15495,0.245111326,0.734624072,7585,0.489512746,IN,Jasper County,18073
1926,6361,8466,0.227498228,0.751358375,4435,0.523860146,IN,Jay County,18075
4731,9659,14725,0.321290323,0.655959253,4928,0.33466893,IN,Jefferson County,18077
2523,9490,12251,0.205942372,0.774630642,6967,0.56868827,IN,Jennings County,18079
24729,51209,77784,0.317918852,0.658348761,26480,0.340429908,IN,Johnson County,18081
4067,11654,16027,0.253759281,0.727147938,7587,0.473388657,IN,Knox County,18083
8350,26476,35846,0.232940914,0.738604028,18126,0.505663114,IN,Kosciusko County,18085
2355,8110,10633,0.221480297,0.762719834,5755,0.541239537,IN,LaGrange County,18087
124801,91733,220233,0.56667711,0.416527042,-33068,-0.150150068,IN,Lake County,18089
22419,25991,49469,0.453192909,0.525399745,3572,0.072206837,IN,LaPorte County,18091
4961,15601,21071,0.235442077,0.7404015,10640,0.504959423,IN,Lawrence County,18093
19524,31215,51765,0.377166039,0.603013619,11691,0.22584758,IN,Madison County,18095
247265,133968,390405,0.633355106,0.343151343,-113297,-0.290203763,IN,Marion County,18097
5712,13844,19918,0.286775781,0.695049704,8132,0.408273923,IN,Marshall County,18099
1011,4029,5155,0.196120272,0.78157129,3018,0.585451018,IN,Martin County,18101
3235,10925,14493,0.223211205,0.753812185,7690,0.53060098,IN,Miami County,18103
39861,22071,63037,0.63234291,0.350127703,-17790,-0.282215207,IN,Monroe County,18105
4213,12659,17198,0.244970345,0.736073962,8446,0.491103617,IN,Montgomery County,18107
7777,27510,36214,0.214751201,0.759650964,19733,0.544899763,IN,Morgan County,18109
1509,4942,6591,0.228948566,0.749810347,3433,0.520861781,IN,Newton County,18111
4660,14195,19217,0.242493625,0.738668887,9535,0.496175261,IN,Noble County,18113
750,2392,3164,0.237041719,0.756005057,1642,0.518963338,IN,Ohio County,18115
2224,6432,8830,0.25186863,0.728425821,4208,0.476557191,IN,Orange County,18117
2419,7285,9915,0.243973777,0.734745335,4866,0.490771558,IN,Owen County,18119
1503,5398,7020,0.214102564,0.768945869,3895,0.554843305,IN,Parke County,18121
3202,5343,8734,0.366613236,0.611747195,2141,0.245133959,IN,Perry County,18123
1415,4692,6220,0.227491961,0.754340836,3277,0.526848875,IN,Pike County,18125
39746,45008,86410,0.459969911,0.520865641,5262,0.06089573,IN,Porter County,18127
3811,9206,13264,0.287319059,0.694059107,5395,0.406740048,IN,Posey County,18129
1463,4246,5813,0.251677275,0.730431791,2783,0.478754516,IN,Pulaski County,18131
3946,12278,16595,0.237782465,0.739861404,8332,0.502078939,IN,Putnam County,18133
2512,8312,11078,0.226755732,0.750315942,5800,0.523560209,IN,Randolph County,18135
2774,11261,14264,0.194475603,0.789469994,8487,0.594994391,IN,Ripley County,18137
1754,6035,7932,0.221129602,0.760842158,4281,0.539712557,IN,Rush County,18139
59870,53152,115547,0.518144132,0.460003289,-6718,-0.058140843,IN,St. Joseph County,18141
2698,7328,10176,0.265133648,0.720125786,4630,0.454992138,IN,Scott County,18143
5023,14568,20017,0.250936704,0.727781386,9545,0.476844682,IN,Shelby County,18145
3208,7354,10781,0.297560523,0.682125962,4146,0.384565439,IN,Spencer County,18147
2650,7466,10309,0.257056941,0.724221554,4816,0.467164613,IN,Starke County,18149
4509,11322,16175,0.278763524,0.699969088,6813,0.421205564,IN,Steuben County,18151
2153,6687,9004,0.239115948,0.742669924,4534,0.503553976,IN,Sullivan County,18153
964,3133,4152,0.232177264,0.754576108,2169,0.522398844,IN,Switzerland County,18155
35017,34581,71430,0.490228195,0.484124318,-436,-0.006103878,IN,Tippecanoe County,18157
1834,6110,8124,0.225750862,0.752092565,4276,0.526341704,IN,Tipton County,18159
736,2687,3491,0.210827843,0.769693498,1951,0.558865655,IN,Union County,18161
34415,41844,77581,0.443600882,0.539358864,7429,0.095757982,IN,Vanderburgh County,18163
2145,5184,7480,0.286764706,0.693048128,3039,0.406283422,IN,Vermillion County,18165
18080,24512,43593,0.414745487,0.562292111,6432,0.147546624,IN,Vigo County,18167
3494,10762,14598,0.239347856,0.737224277,7268,0.497876421,IN,Wabash County,18169
974,3401,4473,0.21775095,0.760339817,2427,0.542588867,IN,Warren County,18171
11919,21324,33884,0.351758942,0.629323575,9405,0.277564632,IN,Warrick County,18173
2784,9114,12131,0.229494683,0.751298327,6330,0.521803644,IN,Washington County,18175
9524,17567,27662,0.344299038,0.635058926,8043,0.290759887,IN,Wayne County,18177
2928,10855,14080,0.207954545,0.770951705,7927,0.562997159,IN,Wells County,18179
3032,7957,11159,0.271708934,0.713056726,4925,0.441347791,IN,White County,18181
4233,12856,17581,0.240771287,0.731243957,8623,0.490472669,IN,Whitley County,18183
1197,2917,4183,0.28615826,0.697346402,1720,0.411188142,IA,Adair County,19001
590,1528,2158,0.273401297,0.708063021,938,0.434661724,IA,Adams County,19003
2575,4733,7459,0.345220539,0.634535461,2158,0.289314922,IA,Allamakee County,19005
1891,4512,6506,0.29065478,0.69351368,2621,0.402858899,IA,Appanoose County,19007
1071,2295,3416,0.31352459,0.671838407,1224,0.358313817,IA,Audubon County,19009
5156,9179,14627,0.352498804,0.627538114,4023,0.275039311,IA,Benton County,19011
35621,29623,66549,0.535259733,0.445130656,-5998,-0.090129078,IA,Black Hawk County,19013
6303,8695,15306,0.411799294,0.568077878,2392,0.156278584,IA,Boone County,19015
5954,8287,14534,0.409660107,0.570180267,2333,0.16052016,IA,Bremer County,19017
4169,6420,10764,0.38730955,0.596432553,2251,0.209123003,IA,Buchanan County,19019
2961,5056,8149,0.363357467,0.620444226,2095,0.257086759,IA,Buena Vista County,19021
2424,5542,8084,0.299851559,0.685551707,3118,0.385700148,IA,Butler County,19023
1470,3689,5249,0.280053343,0.702800533,2219,0.42274719,IA,Calhoun County,19025
3454,7737,11306,0.305501504,0.684326906,4283,0.378825402,IA,Carroll County,19027
2201,4969,7266,0.302917699,0.68387008,2768,0.380952381,IA,Cass County,19029
4337,6161,10703,0.405213492,0.575633,1824,0.170419509,IA,Cedar County,19031
10941,12435,23794,0.459821804,0.522610742,1494,0.062788938,IA,Cerro Gordo County,19033
1936,4495,6503,0.29770875,0.691219437,2559,0.393510687,IA,Cherokee County,19035
2233,4308,6617,0.337464108,0.651050325,2075,0.313586217,IA,Chickasaw County,19037
1466,3140,4666,0.314187741,0.672953279,1674,0.358765538,IA,Clarke County,19039
2662,6137,8948,0.297496647,0.685851587,3475,0.38835494,IA,Clay County,19041
3340,6106,9581,0.348606617,0.637302996,2766,0.288696378,IA,Clayton County,19043
10806,13349,24669,0.438039645,0.541124488,2543,0.103084843,IA,Clinton County,19045
2220,4854,7146,0.310663308,0.679261125,2634,0.368597817,IA,Crawford County,19047
26879,27987,55847,0.481297115,0.501137035,1108,0.01983992,IA,Dallas County,19049
1013,3032,4099,0.247133447,0.739692608,2019,0.492559161,IA,Davis County,19051
1120,2615,3801,0.2946593,0.687976848,1495,0.393317548,IA,Decatur County,19053
3157,6666,9981,0.316300972,0.667868951,3509,0.351567979,IA,Delaware County,19055
8887,10589,19947,0.445530656,0.53085677,1702,0.085326114,IA,Des Moines County,19057
3661,7438,11230,0.326001781,0.662333037,3777,0.336331256,IA,Dickinson County,19059
25655,27214,53924,0.475762184,0.504673244,1559,0.02891106,IA,Dubuque County,19061
1520,3265,4850,0.313402062,0.673195876,1745,0.359793814,IA,Emmet County,19063
3834,6145,10184,0.376472899,0.603397486,2311,0.226924588,IA,Fayette County,19065
3168,4730,8026,0.394717169,0.589334662,1562,0.194617493,IA,Floyd County,19067
1626,3422,5119,0.317640164,0.668489939,1796,0.350849775,IA,Franklin County,19069
1078,2711,3855,0.279636835,0.703242542,1633,0.423605707,IA,Fremont County,19071
1768,3221,5054,0.349821923,0.637316977,1453,0.287495053,IA,Greene County,19073
2206,4929,7260,0.303856749,0.67892562,2723,0.375068871,IA,Grundy County,19075
1985,4272,6369,0.311665882,0.67074894,2287,0.359083059,IA,Guthrie County,19077
2842,4956,8516,0.333724753,0.581963363,2114,0.24823861,IA,Hamilton County,19079
1683,4390,6161,0.27316994,0.712546665,2707,0.439376725,IA,Hancock County,19081
2976,5850,8975,0.331587744,0.651810585,2874,0.320222841,IA,Hardin County,19083
2440,5569,8144,0.299607073,0.683816306,3129,0.384209234,IA,Harrison County,19085
3275,6507,9964,0.32868326,0.653050984,3232,0.324367724,IA,Henry County,19087
1772,3127,4952,0.357835218,0.631462036,1355,0.273626817,IA,Howard County,19089
1442,3819,5321,0.271001691,0.717722233,2377,0.446720541,IA,Humboldt County,19091
917,2876,3845,0.238491547,0.747984395,1959,0.509492848,IA,Ida County,19093
3547,6009,9716,0.365067929,0.618464389,2462,0.253396459,IA,Iowa County,19095
4029,6940,11118,0.362385321,0.624212988,2911,0.261827667,IA,Jackson County,19097
7737,12082,20181,0.383380407,0.598681929,4345,0.215301521,IA,Jasper County,19099
4314,4442,8952,0.481903485,0.496201966,128,0.014298481,IA,Jefferson County,19101
59177,22925,83570,0.708112959,0.274320929,-36252,-0.433792031,IA,Johnson County,19103
4213,6572,10965,0.384222526,0.599361605,2359,0.215139079,IA,Jones County,19105
1414,3797,5291,0.267246267,0.717633718,2383,0.45038745,IA,Keokuk County,19107
2696,6275,9077,0.297014432,0.691307701,3579,0.394293269,IA,Kossuth County,19109
6539,9763,16721,0.391065128,0.583876562,3224,0.192811435,IA,Lee County,19111
70874,53364,127078,0.557720455,0.419931066,-17510,-0.137789389,IA,Linn County,19113
1726,3500,5326,0.324070597,0.657153586,1774,0.333082989,IA,Louisa County,19115
1284,3287,4630,0.277321814,0.709935205,2003,0.432613391,IA,Lucas County,19117
1067,5707,6852,0.155720957,0.832895505,4640,0.677174548,IA,Lyon County,19119
3134,6507,9806,0.319600245,0.663573322,3373,0.343973078,IA,Madison County,19121
2894,8297,11381,0.254283455,0.729022054,5403,0.474738599,IA,Mahaska County,19123
6170,12657,19217,0.321069886,0.658635583,6487,0.337565697,IA,Marion County,19125
8171,9564,18122,0.450888423,0.527756318,1393,0.076867895,IA,Marshall County,19127
2500,5572,8247,0.303140536,0.675639627,3072,0.372499091,IA,Mills County,19129
2053,3677,5815,0.353052451,0.632330181,1624,0.27927773,IA,Mitchell County,19131
1407,3248,4714,0.298472635,0.689011455,1841,0.390538821,IA,Monona County,19133
1078,2975,4085,0.263892289,0.728274174,1897,0.464381885,IA,Monroe County,19135
1583,3659,5320,0.297556391,0.687781955,2076,0.390225564,IA,Montgomery County,19137
9372,10823,20629,0.454311891,0.524649765,1451,0.070337874,IA,Muscatine County,19139
1569,5861,7541,0.208062591,0.777217876,4292,0.569155284,IA,O'Brien County,19141
600,2688,3325,0.180451128,0.808421053,2088,0.627969925,IA,Osceola County,19143
2086,5319,7519,0.277430509,0.7074079,3233,0.429977391,IA,Page County,19145
1519,3370,4950,0.306868687,0.680808081,1851,0.373939394,IA,Palo Alto County,19147
3494,10492,14165,0.246664313,0.740698906,6998,0.494034592,IA,Plymouth County,19149
932,2825,3821,0.243915205,0.739335253,1893,0.495420047,IA,Pocahontas County,19151
146250,106800,257991,0.56688024,0.413967929,-39450,-0.152912311,IA,Polk County,19153
18570,26241,45733,0.406052522,0.573786981,7671,0.167734459,IA,Pottawattamie County,19155
4306,5657,10124,0.425325958,0.558771237,1351,0.133445279,IA,Poweshiek County,19157
708,1964,2709,0.261351052,0.724990772,1256,0.463639719,IA,Ringgold County,19159
1389,4061,5527,0.251311742,0.734756649,2672,0.483444907,IA,Sac County,19161
46890,43661,92639,0.506158313,0.471302583,-3229,-0.03485573,IA,Scott County,19163
1959,4697,6781,0.288895443,0.692670698,2738,0.403775254,IA,Shelby County,19165
3019,15680,18956,0.159263558,0.82717873,12661,0.667915172,IA,Sioux County,19167
29175,20340,50837,0.573893031,0.400102288,-8835,-0.173790743,IA,Story County,19169
3577,5303,9026,0.396299579,0.587524928,1726,0.191225349,IA,Tama County,19171
746,2463,3242,0.230104874,0.759716225,1717,0.529611351,IA,Taylor County,19173
2061,4010,6171,0.333981526,0.649813644,1949,0.315832118,IA,Union County,19175
875,2859,3788,0.230992608,0.754751848,1984,0.52375924,IA,Van Buren County,19177
5821,9516,15613,0.372830334,0.60949209,3695,0.236661756,IA,Wapello County,19179
12537,17738,30955,0.405007269,0.573025359,5201,0.168018091,IA,Warren County,19181
4558,6966,11757,0.387683933,0.592498086,2408,0.204814153,IA,Washington County,19183
727,2338,3103,0.234289397,0.753464389,1611,0.519174992,IA,Wayne County,19185
6604,10927,17802,0.370969554,0.613807437,4323,0.242837883,IA,Webster County,19187
2135,3707,5951,0.358763233,0.622920518,1572,0.264157284,IA,Winnebago County,19189
5617,6235,12036,0.466683283,0.518029246,618,0.051345962,IA,Winneshiek County,19191
18704,25736,45172,0.414061808,0.569733463,7032,0.155671655,IA,Woodbury County,19193
1596,2738,4414,0.361576801,0.620299048,1142,0.258722247,IA,Worth County,19195
1996,4136,6242,0.319769305,0.662608138,2140,0.342838834,IA,Wright County,19197
1559,4155,5842,0.266860664,0.711229031,2596,0.444368367,KS,Allen County,20001
765,2874,3720,0.205645161,0.772580645,2109,0.566935484,KS,Anderson County,20003
2314,4826,7312,0.316466083,0.660010941,2512,0.343544858,KS,Atchison County,20005
284,1992,2313,0.122784263,0.861219196,1708,0.738434933,KS,Barber County,20007
2302,8480,10961,0.210017334,0.773652039,6178,0.563634705,KS,Barton County,20009
1505,4910,6550,0.229770992,0.749618321,3405,0.519847328,KS,Bourbon County,20011
1088,3206,4396,0.247497725,0.729299363,2118,0.481801638,KS,Brown County,20013
9003,22250,31946,0.28181932,0.696487823,13247,0.414668503,KS,Butler County,20015
341,1114,1478,0.230717185,0.753721245,773,0.52300406,KS,Chase County,20017
212,1397,1634,0.129742962,0.85495716,1185,0.725214198,KS,Chautauqua County,20019
2163,6622,8945,0.241811068,0.740301845,4459,0.498490777,KS,Cherokee County,20021
220,1158,1400,0.157142857,0.827142857,938,0.67,KS,Cheyenne County,20023
143,885,1048,0.136450382,0.844465649,742,0.708015267,KS,Clark County,20025
883,3129,4134,0.213594582,0.756894049,2246,0.543299468,KS,Clay County,20027
893,3182,4174,0.21394346,0.762338285,2289,0.548394825,KS,Cloud County,20029
928,3407,4448,0.208633094,0.76596223,2479,0.557329137,KS,Coffey County,20031
126,745,904,0.139380531,0.824115044,619,0.684734513,KS,Comanche County,20033
4171,9442,13911,0.299834663,0.67874344,5271,0.378908777,KS,Cowley County,20035
5971,9752,16125,0.370294574,0.604775194,3781,0.23448062,KS,Crawford County,20037
208,1232,1458,0.14266118,0.844993141,1024,0.702331962,KS,Decatur County,20039
2040,7045,9246,0.220635951,0.761951114,5005,0.541315163,KS,Dickinson County,20041
678,2949,3674,0.184540011,0.802667392,2271,0.618127382,KS,Doniphan County,20043
39436,16737,57540,0.685366701,0.290875912,-22699,-0.394490789,KS,Douglas County,20045
267,1127,1413,0.18895966,0.797593772,860,0.608634112,KS,Edwards County,20047
191,1130,1347,0.141796585,0.838901262,939,0.697104677,KS,Elk County,20049
3633,9569,13501,0.269091178,0.708762314,5936,0.439671135,KS,Ellis County,20051
646,2106,2806,0.230220955,0.750534569,1460,0.520313614,KS,Ellsworth County,20053
4155,7079,11466,0.36237572,0.617390546,2924,0.255014826,KS,Finney County,20055
2926,5763,8850,0.330621469,0.651186441,2837,0.320564972,KS,Ford County,20057
3623,8326,12247,0.29582755,0.679839961,4703,0.384012411,KS,Franklin County,20059
3825,5193,9311,0.410804425,0.557727419,1368,0.146922994,KS,Geary County,20061
163,1256,1433,0.113747383,0.876482903,1093,0.76273552,KS,Gove County,20063
222,1052,1302,0.170506912,0.807987711,830,0.637480799,KS,Graham County,20065
497,1910,2452,0.20269168,0.778955954,1413,0.576264274,KS,Grant County,20067
337,1871,2240,0.150446429,0.835267857,1534,0.684821429,KS,Gray County,20069
77,537,629,0.122416534,0.853736089,460,0.731319555,KS,Greeley County,20071
562,2404,3030,0.185478548,0.79339934,1842,0.607920792,KS,Greenwood County,20073
134,684,837,0.160095579,0.817204301,550,0.657108722,KS,Hamilton County,20075
453,2128,2626,0.172505712,0.810357959,1675,0.637852247,KS,Harper County,20077
6652,10015,17034,0.390513091,0.587941764,3363,0.197428672,KS,Harvey County,20079
261,1103,1383,0.188720174,0.797541576,842,0.608821403,KS,Haskell County,20081
151,866,1033,0.146176186,0.838334947,715,0.692158761,KS,Hodgeman County,20083
1852,4435,6468,0.286332715,0.685683364,2583,0.399350649,KS,Jackson County,20085
3106,6193,9581,0.324183279,0.646383467,3087,0.322200188,KS,Jefferson County,20087
211,1369,1608,0.131218905,0.851368159,1158,0.720149254,KS,Jewell County,20089
177925,151280,336277,0.529102496,0.449867223,-26645,-0.079235273,KS,Johnson County,20091
255,1134,1413,0.180467091,0.802547771,879,0.622080679,KS,Kearny County,20093
745,3102,3929,0.189615678,0.789513871,2357,0.599898193,KS,Kingman County,20095
153,957,1139,0.134328358,0.840210711,804,0.705882353,KS,Kiowa County,20097
2607,5639,8414,0.309840742,0.670192536,3032,0.360351795,KS,Labette County,20099
114,757,888,0.128378378,0.852477477,643,0.724099099,KS,Lane County,20101
13753,21378,36115,0.380811297,0.591942406,7625,0.211131109,KS,Leavenworth County,20103
266,1273,1570,0.169426752,0.810828025,1007,0.641401274,KS,Lincoln County,20105
863,3940,4903,0.176014685,0.803589639,3077,0.627574954,KS,Linn County,20107
185,1231,1437,0.128740431,0.85664579,1046,0.727905358,KS,Logan County,20109
5878,7381,13622,0.431507855,0.541844076,1503,0.110336221,KS,Lyon County,20111
3977,9562,13868,0.28677531,0.68950101,5585,0.402725699,KS,McPherson County,20113
1463,4377,5969,0.245099682,0.733288658,2914,0.488188976,KS,Marion County,20115
1239,3662,5023,0.246665339,0.729046387,2423,0.482381047,KS,Marshall County,20117
261,1508,1807,0.144438296,0.834532374,1247,0.690094079,KS,Meade County,20119
5133,12116,17624,0.291250567,0.68747163,6983,0.396221062,KS,Miami County,20121
547,2454,3039,0.179993419,0.807502468,1907,0.627509049,KS,Mitchell County,20123
3147,9768,13177,0.238825226,0.741291645,6621,0.502466419,KS,Montgomery County,20125
721,2085,2849,0.253071253,0.731835732,1364,0.478764479,KS,Morris County,20127
147,1004,1163,0.126397248,0.863284609,857,0.73688736,KS,Morton County,20129
920,4612,5625,0.163555556,0.819911111,3692,0.656355556,KS,Nemaha County,20131
1727,4795,6629,0.260521949,0.723336853,3068,0.462814904,KS,Neosho County,20133
147,1315,1487,0.098856759,0.884330868,1168,0.785474109,KS,Ness County,20135
361,1977,2390,0.151046025,0.827196653,1616,0.676150628,KS,Norton County,20137
2099,5591,7893,0.265931838,0.70834917,3492,0.442417332,KS,Osage County,20139
275,1590,1899,0.14481306,0.83728278,1315,0.692469721,KS,Osborne County,20141
504,2581,3159,0.15954416,0.817030706,2077,0.657486546,KS,Ottawa County,20143
635,2028,2712,0.234144543,0.747787611,1393,0.513643068,KS,Pawnee County,20145
318,2388,2752,0.115552326,0.867732558,2070,0.752180233,KS,Phillips County,20147
3257,9247,12815,0.254155287,0.721576278,5990,0.467420991,KS,Pottawatomie County,20149
924,3087,4107,0.224981738,0.751643535,2163,0.526661797,KS,Pratt County,20151
214,1253,1496,0.143048128,0.837566845,1039,0.694518717,KS,Rawlins County,20153
8602,17948,27245,0.315727656,0.658763076,9346,0.343035419,KS,Reno County,20155
420,2172,2643,0.158910329,0.821793417,1752,0.662883087,KS,Republic County,20157
953,3187,4230,0.225295508,0.753427896,2234,0.528132388,KS,Rice County,20159
11940,11174,23855,0.500523999,0.468413331,-766,-0.032110669,KS,Riley County,20161
332,2294,2661,0.124765126,0.862081924,1962,0.737316798,KS,Rooks County,20163
291,1425,1748,0.166475973,0.815217391,1134,0.648741419,KS,Rush County,20165
591,2765,3429,0.172353456,0.806357539,2174,0.634004083,KS,Russell County,20167
8022,15313,23911,0.335494124,0.640416545,7291,0.304922421,KS,Saline County,20169
290,1991,2322,0.124892334,0.857450474,1701,0.73255814,KS,Scott County,20171
90820,117653,213552,0.425282835,0.55093373,26833,0.125650895,KS,Sedgwick County,20173
1736,3285,5099,0.340458914,0.644243969,1549,0.303785056,KS,Seward County,20175
42032,39890,84061,0.500017844,0.474536349,-2142,-0.025481496,KS,Shawnee County,20177
144,1237,1397,0.103078024,0.885468862,1093,0.782390838,KS,Sheridan County,20179
386,2222,2673,0.144407033,0.83127572,1836,0.686868687,KS,Sherman County,20181
328,1734,2092,0.156787763,0.828871893,1406,0.67208413,KS,Smith County,20183
355,1631,2017,0.176003966,0.808626673,1276,0.632622707,KS,Stafford County,20185
147,607,767,0.191655802,0.791395046,460,0.599739244,KS,Stanton County,20187
233,1731,1997,0.116675013,0.8668002,1498,0.750125188,KS,Stevens County,20189
2551,7998,10779,0.236663883,0.74199833,5447,0.505334447,KS,Sumner County,20191
622,3106,3794,0.163943068,0.818661044,2484,0.654717976,KS,Thomas County,20193
238,1341,1603,0.148471616,0.836556457,1103,0.688084841,KS,Trego County,20195
956,2813,3861,0.247604248,0.728567729,1857,0.480963481,KS,Wabaunsee County,20197
44,762,817,0.053855569,0.932680539,718,0.878824969,KS,Wallace County,20199
467,2332,2843,0.164263102,0.820260288,1865,0.655997186,KS,Washington County,20201
147,803,961,0.152965661,0.835587929,656,0.682622268,KS,Wichita County,20203
711,3111,3899,0.18235445,0.797896897,2400,0.615542447,KS,Wilson County,20205
283,1189,1495,0.189297659,0.795317726,906,0.606020067,KS,Woodson County,20207
35566,18512,55107,0.645398951,0.335928285,-17054,-0.309470666,KS,Wyandotte County,20209
1392,7276,8768,0.158759124,0.829835766,5884,0.671076642,KY,Adair County,21001
1642,7587,9364,0.175352413,0.810230671,5945,0.634878257,KY,Allen County,21003
3348,9661,13254,0.252602988,0.728912027,6313,0.476309039,KY,Anderson County,21005
825,3356,4225,0.195266272,0.794319527,2531,0.599053254,KY,Ballard County,21007
5127,14654,20064,0.255532297,0.730362839,9527,0.474830542,KY,Barren County,21009
1573,3986,5627,0.279545051,0.708370357,2413,0.428825307,KY,Bath County,21011
1789,8140,10044,0.178116288,0.81043409,6351,0.632317802,KY,Bell County,21013
20901,44814,66998,0.311964536,0.668885638,23913,0.356921102,KY,Boone County,21015
3296,6190,9648,0.341625207,0.641583748,2894,0.299958541,KY,Bourbon County,21017
7083,14295,21751,0.3256402,0.657211163,7212,0.331570962,KY,Boyd County,21019
5298,8872,14478,0.365934521,0.612791822,3574,0.246857301,KY,Boyle County,21021
800,3398,4246,0.188412624,0.800282619,2598,0.611869995,KY,Bracken County,21023
1301,4265,5661,0.229818053,0.753400459,2964,0.523582406,KY,Breathitt County,21025
2350,7701,10201,0.230369572,0.754925988,5351,0.524556416,KY,Breckinridge County,21027
10552,30708,41998,0.25125006,0.731177675,20156,0.479927616,KY,Bullitt County,21029
1079,4960,6125,0.176163265,0.809795918,3881,0.633632653,KY,Butler County,21031
1433,4906,6434,0.222723034,0.762511657,3473,0.539788623,KY,Caldwell County,21033
5797,11352,17457,0.332073094,0.650283554,5555,0.31821046,KY,Calloway County,21035
19374,28482,48878,0.396374647,0.58271615,9108,0.186341503,KY,Campbell County,21037
463,2159,2638,0.175511751,0.818423048,1696,0.642911296,KY,Carlisle County,21039
1116,2954,4136,0.269825919,0.714216634,1838,0.444390716,KY,Carroll County,21041
2642,8775,11586,0.228033834,0.757379596,6133,0.529345762,KY,Carter County,21043
918,6179,7171,0.128015618,0.86166504,5261,0.733649421,KY,Casey County,21045
8296,15080,23863,0.347651175,0.631940661,6784,0.284289486,KY,Christian County,21047
6004,11811,18139,0.330999504,0.651138431,5807,0.320138927,KY,Clark County,21049
831,6677,7591,0.109471743,0.879594256,5846,0.770122514,KY,Clay County,21051
603,4280,4932,0.122262774,0.867802109,3677,0.745539335,KY,Clinton County,21053
731,3451,4242,0.172324375,0.813531353,2720,0.641206978,KY,Crittenden County,21055
508,2769,3309,0.153520701,0.836808704,2261,0.683288002,KY,Cumberland County,21057
17286,31025,49287,0.350721286,0.629476333,13739,0.278755047,KY,Daviess County,21059
1227,4828,6132,0.200097847,0.787345075,3601,0.587247228,KY,Edmonson County,21061
712,2246,2995,0.237729549,0.749916528,1534,0.512186978,KY,Elliott County,21063
1355,5100,6540,0.207186544,0.779816514,3745,0.572629969,KY,Estill County,21065
90600,58860,152912,0.592497646,0.384927278,-31740,-0.207570367,KY,Fayette County,21067
1474,5534,7068,0.208545557,0.782965478,4060,0.574419921,KY,Fleming County,21069
3884,12250,16353,0.237509937,0.749098025,8366,0.511588088,KY,Floyd County,21071
12652,12900,26072,0.485271556,0.494783676,248,0.00951212,KY,Franklin County,21073
794,1606,2426,0.327287716,0.661995054,812,0.334707337,KY,Fulton County,21075
822,2955,3849,0.213561964,0.767731878,2133,0.554169914,KY,Gallatin County,21077
1830,6754,8706,0.210199862,0.775786814,4924,0.565586952,KY,Garrard County,21079
2205,8725,11108,0.198505582,0.785469932,6520,0.58696435,KY,Grant County,21081
3560,13206,17019,0.209177978,0.775956284,9646,0.566778307,KY,Graves County,21083
2400,9453,11985,0.200250313,0.78873592,7053,0.588485607,KY,Grayson County,21085
920,4838,5812,0.158293187,0.832415692,3918,0.674122505,KY,Green County,21087
4873,13064,18176,0.268100792,0.71875,8191,0.450649208,KY,Greenup County,21089
1351,3145,4587,0.294528014,0.685633312,1794,0.391105298,KY,Hancock County,21091
18101,29832,48941,0.369853497,0.609550275,11731,0.239696778,KY,Hardin County,21093
1494,9367,10971,0.136177194,0.853796372,7873,0.717619178,KY,Harlan County,21095
2400,6334,8859,0.270910938,0.714979117,3934,0.444068179,KY,Harrison County,21097
1908,6345,8370,0.227956989,0.758064516,4437,0.530107527,KY,Hart County,21099
7639,12730,20697,0.369087307,0.615064985,5091,0.245977678,KY,Henderson County,21101
2142,5843,8110,0.264118372,0.720468557,3701,0.456350185,KY,Henry County,21103
458,1714,2199,0.208276489,0.779445202,1256,0.571168713,KY,Hickman County,21105
5439,15757,21512,0.252835627,0.732474898,10318,0.479639271,KY,Hopkins County,21107
605,5453,6113,0.098969409,0.892033372,4848,0.793063962,KY,Jackson County,21109
228358,150646,386629,0.590638571,0.38963968,-77712,-0.20099889,KY,Jefferson County,21111
8567,17096,26280,0.325989346,0.650532725,8529,0.324543379,KY,Jessamine County,21113
1608,8450,10192,0.157770801,0.829081633,6842,0.671310832,KY,Johnson County,21115
32271,48129,82198,0.392600793,0.585525195,15858,0.192924402,KY,Kenton County,21117
1412,4780,6252,0.225847729,0.764555342,3368,0.538707614,KY,Knott County,21119
2114,11012,13273,0.1592707,0.829654185,8898,0.670383485,KY,Knox County,21121
1504,5685,7301,0.205999178,0.778660457,4181,0.572661279,KY,Larue County,21123
4475,23237,28111,0.159190353,0.826615915,18762,0.667425563,KY,Laurel County,21125
1238,5633,6955,0.178001438,0.80992092,4395,0.631919482,KY,Lawrence County,21127
481,2273,2801,0.171724384,0.811495894,1792,0.63977151,KY,Lee County,21129
446,4321,4813,0.092665697,0.897776854,3875,0.805111157,KY,Leslie County,21131
1799,7226,9135,0.196934866,0.791023536,5427,0.59408867,KY,Letcher County,21133
823,4986,5883,0.139894612,0.847526772,4163,0.70763216,KY,Lewis County,21135
2254,8489,10914,0.206523731,0.77780832,6235,0.571284589,KY,Lincoln County,21137
939,4010,5004,0.18764988,0.801358913,3071,0.613709033,KY,Livingston County,21139
3094,9067,12350,0.250526316,0.73417004,5973,0.483643725,KY,Logan County,21141
1092,3100,4228,0.258278146,0.73320719,2008,0.474929044,KY,Lyon County,21143
11195,21820,33549,0.333691019,0.650391964,10625,0.316700945,KY,McCracken County,21145
725,5664,6438,0.112612613,0.879776328,4939,0.767163715,KY,McCreary County,21147
1074,3633,4782,0.224592221,0.759723965,2559,0.535131744,KY,McLean County,21149
15581,27356,43957,0.35446004,0.622335464,11775,0.267875424,KY,Madison County,21151
1214,4174,5447,0.222874977,0.766293372,2960,0.543418395,KY,Magoffin County,21153
2722,6113,8928,0.304883513,0.684699821,3391,0.379816308,KY,Marion County,21155
4071,13297,17603,0.231267398,0.755382605,9226,0.524115208,KY,Marshall County,21157
403,3496,3936,0.102388211,0.888211382,3093,0.785823171,KY,Martin County,21159
2362,5477,7958,0.296808243,0.688238251,3115,0.391430008,KY,Mason County,21161
3632,10185,14113,0.257351378,0.721675051,6553,0.464323673,KY,Meade County,21163
750,2311,3102,0.241779497,0.745003224,1561,0.503223727,KY,Menifee County,21165
3033,8506,11735,0.258457605,0.724840222,5473,0.466382616,KY,Mercer County,21167
975,3959,5012,0.194533121,0.78990423,2984,0.595371109,KY,Metcalfe County,21169
657,4628,5330,0.12326454,0.868292683,3971,0.745028143,KY,Monroe County,21171
3630,8993,12842,0.282666251,0.70028033,5363,0.417614079,KY,Montgomery County,21173
1175,4301,5544,0.211940837,0.775793651,3126,0.563852814,KY,Morgan County,21175
3545,10497,14235,0.249034071,0.737407798,6952,0.488373727,KY,Muhlenberg County,21177
7188,15703,23256,0.309081527,0.675223598,8515,0.366142071,KY,Nelson County,21179
955,2408,3396,0.281213192,0.709069494,1453,0.427856302,KY,Nicholas County,21181
2404,8582,11129,0.21601222,0.771138467,6178,0.555126247,KY,Ohio County,21183
14505,22654,37976,0.381951759,0.596534653,8149,0.214582894,KY,Oldham County,21185
1098,4292,5458,0.201172591,0.786368633,3194,0.585196043,KY,Owen County,21187
216,1671,1896,0.113924051,0.881329114,1455,0.767405063,KY,Owsley County,21189
1322,5515,6925,0.190902527,0.796389892,4193,0.605487365,KY,Pendleton County,21191
2356,8129,10626,0.221720309,0.765010352,5773,0.543290043,KY,Perry County,21193
4866,20284,25395,0.191612522,0.798739909,15418,0.607127387,KY,Pike County,21195
1367,4041,5505,0.248319709,0.734059946,2674,0.485740236,KY,Powell County,21197
5666,25442,31557,0.179548119,0.806223659,19776,0.626675539,KY,Pulaski County,21199
253,884,1146,0.220767888,0.771378709,631,0.55061082,KY,Robertson County,21201
1134,6577,7784,0.145683453,0.844938335,5443,0.699254882,KY,Rockcastle County,21203
3880,5994,10065,0.385494287,0.595529061,2114,0.210034774,KY,Rowan County,21205
1331,7519,8955,0.148632049,0.839642658,6188,0.691010609,KY,Russell County,21207
10567,17767,28969,0.364769236,0.61331078,7200,0.248541544,KY,Scott County,21209
8077,15055,23550,0.342972399,0.639278132,6978,0.296305732,KY,Shelby County,21211
2681,5888,8732,0.307031608,0.67430142,3207,0.367269812,KY,Simpson County,21213
2530,8737,11433,0.22128925,0.764191376,6207,0.542902125,KY,Spencer County,21215
2963,9376,12517,0.236718063,0.749061277,6413,0.512343213,KY,Taylor County,21217
1205,4062,5363,0.224687675,0.757411896,2857,0.532724222,KY,Todd County,21219
1791,5487,7376,0.242814534,0.743899132,3696,0.501084599,KY,Trigg County,21221
1012,3227,4320,0.234259259,0.746990741,2215,0.512731481,KY,Trimble County,21223
1529,4965,6577,0.232476813,0.754903451,3436,0.522426638,KY,Union County,21225
22479,31791,55401,0.405750799,0.573834407,9312,0.168083609,KY,Warren County,21227
1644,4482,6225,0.264096386,0.72,2838,0.455903614,KY,Washington County,21229
1700,7430,9240,0.183982684,0.804112554,5730,0.62012987,KY,Wayne County,21231
1412,4506,5993,0.23560821,0.75187719,3094,0.51626898,KY,Webster County,21233
2552,12567,15356,0.166189112,0.818377182,10015,0.65218807,KY,Whitley County,21235
839,2097,2979,0.281638134,0.703927492,1258,0.422289359,KY,Wolfe County,21237
6530,8362,15211,0.429294589,0.549733745,1832,0.120439156,KY,Woodford County,21239
5443,22596,28425,0.191486368,0.794934037,17153,0.603447669,LA,Acadia Parish,22001
2108,7574,9810,0.214882773,0.772069317,5466,0.557186544,LA,Allen Parish,22003
20399,40687,62325,0.327300441,0.652819896,20288,0.325519454,LA,Ascension Parish,22005
3833,7271,11235,0.341165999,0.64717401,3438,0.306008011,LA,Assumption Parish,22007
4979,12028,17292,0.287936618,0.695581772,7049,0.407645154,LA,Avoyelles Parish,22009
2542,13575,16357,0.155407471,0.829919912,11033,0.674512441,LA,Beauregard Parish,22011
3067,3891,7050,0.435035461,0.551914894,824,0.116879433,LA,Bienville Parish,22013
15662,38074,54655,0.286561156,0.69662428,22412,0.410063123,LA,Bossier Parish,22015
55110,48021,104912,0.525297392,0.457726476,-7089,-0.067570917,LA,Caddo Parish,22017
25982,55066,82663,0.314312328,0.666150515,29084,0.351838186,LA,Calcasieu Parish,22019
745,3976,4762,0.156446871,0.834943301,3231,0.67849643,LA,Caldwell Parish,22021
324,3671,4039,0.080217876,0.908888339,3347,0.828670463,LA,Cameron Parish,22023
1269,3541,4858,0.261218608,0.728900782,2272,0.467682174,LA,Catahoula Parish,22025
2731,3770,6580,0.415045593,0.572948328,1039,0.157902736,LA,Claiborne Parish,22027
3177,5550,8828,0.359877662,0.628681468,2373,0.268803806,LA,Concordia Parish,22029
5457,9112,14736,0.37031759,0.61834962,3655,0.24803203,LA,De Soto Parish,22031
115577,88420,208182,0.555172878,0.42472452,-27157,-0.130448358,LA,East Baton Rouge Parish,22033
1900,1080,3036,0.625823452,0.355731225,-820,-0.270092227,LA,East Carroll Parish,22035
4280,6064,10509,0.407269959,0.577029213,1784,0.169759254,LA,East Feliciana Parish,22037
4158,11053,15412,0.269789774,0.71716844,6895,0.447378666,LA,Evangeline Parish,22039
2658,6970,9720,0.27345679,0.717078189,4312,0.443621399,LA,Franklin Parish,22041
1157,8117,9392,0.123189949,0.864246167,6960,0.741056218,LA,Grant Parish,22043
11027,21251,32713,0.337083117,0.649619417,10224,0.312536301,LA,Iberia Parish,22045
8514,7893,16719,0.509240983,0.472097613,-621,-0.03714337,LA,Iberville Parish,22047
2143,5394,7632,0.280791405,0.706761006,3251,0.425969602,LA,Jackson Parish,22049
84477,105949,193733,0.436048582,0.546881533,21472,0.110832951,LA,Jefferson Parish,22051
3208,11423,14841,0.216157941,0.769692069,8215,0.553534128,LA,Jefferson Davis Parish,22053
39685,72519,114521,0.346530331,0.633237572,32834,0.286707241,LA,Lafayette Parish,22055
8672,36024,45388,0.191063717,0.793689962,27352,0.602626245,LA,Lafourche Parish,22057
638,6378,7077,0.090151194,0.901229334,5740,0.81107814,LA,LaSalle Parish,22059
7559,11311,19275,0.392166018,0.586822309,3752,0.194656291,LA,Lincoln Parish,22061
9249,54877,65230,0.141790587,0.841284685,45628,0.699494098,LA,Livingston Parish,22063
2654,1930,4670,0.568308351,0.413276231,-724,-0.15503212,LA,Madison Parish,22065
4946,6510,11574,0.427337135,0.5624676,1564,0.135130465,LA,Morehouse Parish,22067
6896,9358,16554,0.416576054,0.565301438,2462,0.148725384,LA,Natchitoches Parish,22069
147854,26664,177819,0.831485949,0.14995023,-121190,-0.681535719,LA,Orleans Parish,22071
25913,42255,69166,0.374649394,0.610921551,16342,0.236272157,LA,Ouachita Parish,22073
3414,7412,11014,0.30996913,0.672961685,3998,0.362992555,LA,Plaquemines Parish,22075
4683,7503,12371,0.378546601,0.60649907,2820,0.227952469,LA,Pointe Coupee Parish,22077
19475,38347,58865,0.330841757,0.651439735,18872,0.320597978,LA,Rapides Parish,22079
1644,2413,4132,0.397870281,0.583978703,769,0.186108422,LA,Red River Parish,22081
3225,6607,9940,0.32444668,0.664688129,3382,0.340241449,LA,Richland Parish,22083
1731,8776,10596,0.163363533,0.828237071,7045,0.664873537,LA,Sabine Parish,22085
6151,11179,17650,0.348498584,0.633371105,5028,0.284872521,LA,St. Bernard Parish,22087
9800,18233,28517,0.343654662,0.639373006,8433,0.295718343,LA,St. Charles Parish,22089
3346,2714,6158,0.543358233,0.440727509,-632,-0.102630724,LA,St. Helena Parish,22091
6510,5954,12590,0.517077045,0.472915012,-556,-0.044162033,LA,St. James Parish,22093
13582,7538,21432,0.633725271,0.351717059,-6044,-0.282008212,LA,St. John the Baptist Parish,22095
17372,23171,41154,0.422121786,0.56303154,5799,0.140909754,LA,St. Landry Parish,22097
8439,18203,27038,0.312116281,0.673237666,9764,0.361121385,LA,St. Martin Parish,22099
8055,14811,23186,0.347407919,0.63879065,6756,0.291382731,LA,St. Mary Parish,22101
37746,99666,140110,0.269402612,0.711341089,61920,0.441938477,LA,St. Tammany Parish,22103
18887,37806,57661,0.327552418,0.655659805,18919,0.328107386,LA,Tangipahoa Parish,22105
1329,1197,2554,0.520360219,0.468676586,-132,-0.051683634,LA,Tensas Parish,22107
11198,34339,46240,0.24217128,0.742625433,23141,0.500454152,LA,Terrebonne Parish,22109
2654,8407,11201,0.23694313,0.750557986,5753,0.513614856,LA,Union Parish,22111
5009,21930,27324,0.183318694,0.802591129,16921,0.619272434,LA,Vermilion Parish,22113
2898,14107,17268,0.167824878,0.816944637,11209,0.649119759,LA,Vernon Parish,22115
5970,13307,19513,0.30594988,0.681955619,7337,0.37600574,LA,Washington Parish,22117
6172,11830,18216,0.338823013,0.649429073,5658,0.310606061,LA,Webster Parish,22119
6200,7684,14097,0.439809889,0.545080514,1484,0.105270625,LA,West Baton Rouge Parish,22121
710,4317,5052,0.140538401,0.854513064,3607,0.713974663,LA,West Carroll Parish,22123
2298,3863,6268,0.366624123,0.616305041,1565,0.249680919,LA,West Feliciana Parish,22125
1543,4619,6225,0.247871486,0.742008032,3076,0.494136546,LA,Winn Parish,22127
27617,29268,58796,0.469708824,0.497788965,1651,0.028080142,ME,Androscoggin County,23001
14884,22071,37807,0.393683709,0.583780781,7187,0.190097072,ME,Aroostook County,23003
128759,59584,194180,0.663090947,0.306849315,-69175,-0.356241631,ME,Cumberland County,23005
8038,8737,17433,0.461079562,0.501175931,699,0.040096369,ME,Franklin County,23007
19363,14975,35380,0.547286603,0.42326173,-4388,-0.124024873,ME,Hancock County,23009
34902,34721,71899,0.485430952,0.482913531,-181,-0.00251742,ME,Kennebec County,23011
15110,9982,25734,0.587160954,0.387891505,-5128,-0.199269449,ME,Knox County,23013
12684,10256,23617,0.537070754,0.434263454,-2428,-0.1028073,ME,Lincoln County,23015
14603,17539,33205,0.439783165,0.528203584,2936,0.088420419,ME,Oxford County,23017
37563,44477,84948,0.442188162,0.523579131,6914,0.081390969,ME,Penobscot County,23019
3517,6143,9918,0.354607784,0.619378907,2626,0.264771123,ME,Piscataquis County,23021
13528,9755,24038,0.562775605,0.405815792,-3773,-0.156959814,ME,Sagadahoc County,23023
10136,16471,27367,0.370373077,0.60185625,6335,0.231483173,ME,Somerset County,23025
12632,11477,24956,0.506170861,0.459889405,-1155,-0.046281455,ME,Waldo County,23027
6752,10173,17332,0.389568428,0.586948996,3421,0.197380568,ME,Washington County,23029
71189,54817,129818,0.548375418,0.422260395,-16372,-0.126115023,ME,York County,23031
9158,20886,30511,0.300154043,0.684540002,11728,0.384385959,MD,Allegany County,24001
172823,127821,306924,0.563080763,0.416458146,-45002,-0.146622617,MD,Anne Arundel County,24003
258409,146202,411906,0.627349444,0.354940205,-112207,-0.272409239,MD,Baltimore County,24005
22587,25346,48832,0.462545052,0.519044889,2759,0.056499836,MD,Calvert County,24009
5095,10283,15729,0.323923962,0.65376057,5188,0.329836608,MD,Caroline County,24011
36456,60218,99408,0.366731048,0.605766136,23762,0.239035088,MD,Carroll County,24013
16809,29439,47273,0.355572949,0.622744484,12630,0.267171536,MD,Cecil County,24015
62171,25579,89063,0.698056432,0.287201195,-36592,-0.410855237,MD,Charles County,24017
6857,8764,15934,0.430337643,0.550018828,1907,0.119681185,MD,Dorchester County,24019
77675,63682,144568,0.53729041,0.440498589,-13993,-0.096791821,MD,Frederick County,24021
3281,12002,15579,0.210604018,0.770396046,8721,0.559792028,MD,Garrett County,24023
63095,80930,147221,0.428573369,0.549717771,17835,0.121144402,MD,Harford County,24025
129433,48390,181324,0.713821667,0.266870354,-81043,-0.446951314,MD,Howard County,24027
5329,5195,10740,0.496182495,0.483705773,-134,-0.012476723,MD,Kent County,24029
419569,101222,529569,0.792283914,0.191140342,-318347,-0.601143571,MD,Montgomery County,24031
379208,37090,422851,0.896788703,0.087714112,-342118,-0.809074591,MD,Prince George's County,24033
10709,18741,30079,0.356029123,0.623059277,8032,0.267030154,MD,Queen Anne's County,24035
23138,30826,55339,0.418113808,0.557039339,7688,0.138925532,MD,St. Mary's County,24037
4241,5739,10117,0.419195414,0.567263023,1498,0.148067609,MD,Somerset County,24039
11062,10946,22400,0.493839286,0.488660714,-116,-0.005178571,MD,Talbot County,24041
26044,40224,67510,0.385779884,0.595822841,14180,0.210042957,MD,Washington County,24043
22054,22944,45975,0.479695487,0.499053834,890,0.019358347,MD,Wicomico County,24045
12560,18571,31567,0.397883866,0.588304242,6011,0.190420376,MD,Worcester County,24047
207260,25374,236189,0.877517581,0.107430913,-181886,-0.770086668,MD,Baltimore city,24510
91994,55311,150335,0.611926697,0.367918316,-36683,-0.244008381,MA,Barnstable County,25001
51705,18064,71375,0.72441331,0.253085814,-33641,-0.471327496,MA,Berkshire County,25003
153377,119872,279279,0.549189162,0.429219526,-33505,-0.119969636,MA,Bristol County,25005
9914,2631,12798,0.774652289,0.205578997,-7283,-0.569073293,MA,Dukes County,25007
267198,144837,421210,0.634358159,0.343859358,-122361,-0.290498801,MA,Essex County,25009
30030,11201,42459,0.707270543,0.263807438,-18829,-0.443463106,MA,Franklin County,25011
125948,87318,218177,0.577274415,0.400216338,-38630,-0.177058077,MA,Hampden County,25013
63362,22281,87852,0.721235715,0.253619724,-41081,-0.467615991,MA,Hampshire County,25015
617196,226956,863628,0.714654921,0.262793703,-390240,-0.451861218,MA,Middlesex County,25017
5241,1914,7306,0.717355598,0.261976458,-3327,-0.45537914,MA,Nantucket County,25019
273312,125294,407756,0.670283209,0.307276901,-148018,-0.363006308,MA,Norfolk County,25021
173630,121227,301812,0.575291904,0.40166395,-52403,-0.173627954,MA,Plymouth County,25023
270522,58613,335462,0.806416226,0.174723218,-211909,-0.631693008,MA,Suffolk County,25025
248773,171683,432024,0.575831435,0.397392275,-77090,-0.178439161,MA,Worcester County,25027
2142,4848,7063,0.303270565,0.686393884,2706,0.383123319,MI,Alcona County,26001
2053,3014,5135,0.399805258,0.586952288,961,0.18714703,MI,Alger County,26003
24449,41392,67195,0.363851477,0.615998214,16943,0.252146737,MI,Allegan County,26005
6000,10686,16966,0.353648473,0.629847931,4686,0.276199458,MI,Alpena County,26007
5960,9748,15969,0.37322312,0.610432713,3788,0.237209594,MI,Antrim County,26009
2774,5928,8831,0.314120711,0.671271657,3154,0.357150946,MI,Arenac County,26011
1478,2512,4036,0.366204163,0.622398414,1034,0.256194252,MI,Baraga County,26013
11797,23471,35905,0.328561482,0.653697257,11674,0.325135775,MI,Barry County,26015
26151,33125,60253,0.434019883,0.549765157,6974,0.115745274,MI,Bay County,26017
5480,6601,12260,0.446982055,0.538417618,1121,0.091435563,MI,Benzie County,26019
37438,43519,82379,0.454460481,0.528277838,6081,0.073817356,MI,Berrien County,26021
6159,14064,20536,0.299912349,0.684846124,7905,0.384933775,MI,Branch County,26023
28877,36221,66276,0.43570825,0.546517593,7344,0.110809343,MI,Calhoun County,26025
9130,16699,26242,0.347915555,0.636346315,7569,0.28843076,MI,Cass County,26027
6939,9841,17000,0.408176471,0.578882353,2902,0.170705882,MI,Charlevoix County,26029
5437,10186,15868,0.342639274,0.641920847,4749,0.299281573,MI,Cheboygan County,26031
6648,10681,17671,0.376209609,0.604436648,4033,0.228227039,MI,Chippewa County,26033
5199,10861,16281,0.31932928,0.667096616,5662,0.347767336,MI,Clare County,26035
21968,25098,47910,0.458526404,0.523857232,3130,0.065330829,MI,Clinton County,26037
2672,5087,7861,0.339905864,0.647118687,2415,0.307212823,MI,Crawford County,26039
7606,13207,21156,0.359519758,0.624267347,5601,0.264747589,MI,Delta County,26041
4744,9617,14589,0.325176503,0.659195284,4873,0.334018781,MI,Dickinson County,26043
31299,31798,64454,0.485602135,0.49334409,499,0.007741956,MI,Eaton County,26045
9662,12135,22176,0.435696248,0.547213203,2473,0.111516955,MI,Emmet County,26047
119390,98714,221781,0.538323842,0.44509674,-20676,-0.093227102,MI,Genesee County,26049
4524,9893,14603,0.309799356,0.677463535,5369,0.367664179,MI,Gladwin County,26051
3570,4600,8276,0.431367811,0.55582407,1030,0.124456259,MI,Gogebic County,26053
28683,30502,60227,0.476248194,0.506450595,1819,0.030202401,MI,Grand Traverse County,26055
6693,12102,19148,0.349540422,0.632024232,5409,0.28248381,MI,Gratiot County,26057
5883,17037,23288,0.252619375,0.731578495,11154,0.478959121,MI,Hillsdale County,26059
7750,10378,18533,0.418172989,0.5599741,2628,0.141801112,MI,Houghton County,26061
5490,12731,18452,0.297528723,0.689952309,7241,0.392423586,MI,Huron County,26063
94212,47639,144788,0.650689284,0.329025886,-46573,-0.321663398,MI,Ingham County,26065
10901,20657,32205,0.338487812,0.641422139,9756,0.302934327,MI,Ionia County,26067
5373,9759,15387,0.349190875,0.634236693,4386,0.285045818,MI,Iosco County,26069
2493,4216,6795,0.366887417,0.620456218,1723,0.253568801,MI,Iron County,26071
14072,14815,29409,0.478492978,0.503757353,743,0.025264375,MI,Isabella County,26073
31995,47372,81014,0.39493174,0.58473844,15377,0.1898067,MI,Jackson County,26075
83686,56823,143376,0.583682067,0.39632156,-26863,-0.187360507,MI,Kalamazoo County,26077
3002,7436,10630,0.282408278,0.699529633,4434,0.417121355,MI,Kalkaska County,26079
187915,165741,360839,0.520772422,0.459321193,-22174,-0.061451229,MI,Kent County,26081
672,862,1557,0.431599229,0.553628773,190,0.122029544,MI,Keweenaw County,26083
2288,3946,6332,0.361339229,0.623183828,1658,0.261844599,MI,Lake County,26085
16367,35482,52640,0.310923252,0.674050152,19115,0.3631269,MI,Lapeer County,26087
8795,7916,16933,0.519399988,0.467489518,-879,-0.051910471,MI,Leelanau County,26089
20918,31541,53452,0.391341765,0.59008082,10623,0.198739056,MI,Lenawee County,26091
48220,76982,127166,0.379189406,0.605366214,28762,0.226176808,MI,Livingston County,26093
842,2109,3001,0.280573142,0.702765745,1267,0.422192602,MI,Luce County,26095
2632,4304,7015,0.375196009,0.613542409,1672,0.238346401,MI,Mackinac County,26097
223952,263863,494219,0.453143242,0.53389894,39911,0.080755697,MI,Macomb County,26099
6107,8321,14654,0.416746281,0.567831309,2214,0.151085028,MI,Manistee County,26101
20465,16286,37458,0.54634524,0.434780287,-4179,-0.111564953,MI,Marquette County,26103
6802,10207,17249,0.394341701,0.591744449,3405,0.197402748,MI,Mason County,26105
7375,13267,21081,0.349841089,0.629334472,5892,0.279493383,MI,Mecosta County,26107
4316,8117,12621,0.341969733,0.643134458,3801,0.301164725,MI,Menominee County,26109
20493,27675,49175,0.416736146,0.562785968,7182,0.146049822,MI,Midland County,26111
1967,6648,8755,0.224671616,0.759337521,4681,0.534665905,MI,Missaukee County,26113
32975,52710,87148,0.378379309,0.604833157,19735,0.226453849,MI,Monroe County,26115
9703,21815,32086,0.302406034,0.679891541,12112,0.377485508,MI,Montcalm County,26117
1628,4171,5863,0.277673546,0.711410541,2543,0.433736995,MI,Montmorency County,26119
45643,45133,92435,0.493784822,0.488267431,-510,-0.005517391,MI,Muskegon County,26121
7873,18857,27156,0.289917514,0.694395345,10984,0.404477832,MI,Newaygo County,26123
434148,325971,771991,0.562374432,0.422247151,-108177,-0.140127281,MI,Oakland County,26125
4944,8892,14080,0.351136364,0.631534091,3948,0.280397727,MI,Oceana County,26127
3475,8253,11907,0.291845133,0.693121693,4778,0.40127656,MI,Ogemaw County,26129
1391,2358,3810,0.365091864,0.618897638,967,0.253805774,MI,Ontonagon County,26131
3214,8928,12340,0.260453809,0.72350081,5714,0.463047002,MI,Osceola County,26133
1342,3466,4874,0.275338531,0.71112023,2124,0.435781699,MI,Oscoda County,26135
4743,9779,14756,0.321428571,0.662713472,5036,0.341284901,MI,Otsego County,26137
64705,100913,168627,0.383716724,0.598439159,36208,0.214722435,MI,Ottawa County,26139
2911,5342,8355,0.348414123,0.639377618,2431,0.290963495,MI,Presque Isle County,26141
5166,9670,15018,0.343987215,0.643893994,4504,0.299906779,MI,Roscommon County,26143
51088,50785,103347,0.49433462,0.49140275,-303,-0.00293187,MI,Saginaw County,26145
31363,59185,92063,0.34066889,0.642874988,27822,0.302206098,MI,St. Clair County,26147
9262,18127,27981,0.331010328,0.647832458,8865,0.316822129,MI,St. Joseph County,26149
5966,16194,22446,0.26579346,0.721464849,10228,0.455671389,MI,Sanilac County,26151
1589,3090,4745,0.33487882,0.651211802,1501,0.316332982,MI,Schoolcraft County,26153
15347,23149,39220,0.391305456,0.590234574,7802,0.198929118,MI,Shiawassee County,26155
8712,20297,29479,0.295532413,0.688524034,11585,0.392991621,MI,Tuscola County,26157
16803,21591,39063,0.430151294,0.552722525,4788,0.122571231,MI,Van Buren County,26159
157136,56241,216931,0.724359359,0.259257552,-100895,-0.465101807,MI,Washtenaw County,26161
597170,264553,874018,0.683246798,0.302685986,-332617,-0.380560812,MI,Wayne County,26163
5838,12102,18292,0.319155915,0.6616007,6264,0.342444785,MI,Wexford County,26165
3607,6258,10025,0.359800499,0.624239401,2651,0.264438903,MN,Aitkin County,27001
100893,104902,211132,0.477866927,0.496855048,4009,0.018988121,MN,Anoka County,27003
6589,12438,19401,0.339621669,0.641100974,5849,0.301479305,MN,Becker County,27005
11426,12188,24189,0.472363471,0.503865393,762,0.031501922,MN,Beltrami County,27007
7280,14382,22260,0.327044025,0.646091644,7102,0.319047619,MN,Benton County,27009
1053,1863,2974,0.354068594,0.626429052,810,0.272360457,MN,Big Stone County,27011
18330,16731,36051,0.508446368,0.464092536,-1599,-0.044353832,MN,Blue Earth County,27013
4753,9552,14635,0.324769388,0.652681927,4799,0.327912538,MN,Brown County,27015
10098,9791,20369,0.495753351,0.480681428,-307,-0.015071923,MN,Carlton County,27017
30774,34009,66361,0.463736231,0.512484743,3235,0.048748512,MN,Carver County,27019
6342,11620,18289,0.346765816,0.635354585,5278,0.288588769,MN,Cass County,27021
2226,4250,6611,0.336711541,0.642867947,2024,0.306156406,MN,Chippewa County,27023
11806,21916,34570,0.34150998,0.633960081,10110,0.292450101,MN,Chisago County,27025
16357,15043,32239,0.507366854,0.466608766,-1314,-0.040758088,MN,Clay County,27027
1260,3372,4708,0.267629567,0.716227698,2112,0.448598131,MN,Clearwater County,27029
2496,1203,3806,0.655806621,0.316079874,-1293,-0.339726747,MN,Cook County,27031
1834,4165,6107,0.300311118,0.682004257,2331,0.381693139,MN,Cottonwood County,27033
13726,25676,40173,0.341672267,0.639135738,11950,0.29746347,MN,Crow Wing County,27035
146155,109638,262259,0.5572926,0.418052383,-36517,-0.139240217,MN,Dakota County,27037
4079,7783,12187,0.334700911,0.638631328,3704,0.303930418,MN,Dodge County,27039
7868,15799,24165,0.325594869,0.653796814,7931,0.328201945,MN,Douglas County,27041
2531,5191,7914,0.31981299,0.655926207,2660,0.336113217,MN,Faribault County,27043
4551,7301,12141,0.374845565,0.601350795,2750,0.22650523,MN,Fillmore County,27045
6889,9578,16818,0.409620645,0.56950886,2689,0.159888215,MN,Freeborn County,27047
11806,16052,28636,0.412278251,0.56055315,4246,0.148274899,MN,Goodhue County,27049
1300,2269,3654,0.355774494,0.620963328,969,0.265188834,MN,Grant County,27051
532623,205973,755969,0.704556668,0.272462231,-326650,-0.432094438,MN,Hennepin County,27053
4853,6334,11440,0.424213287,0.553671329,1481,0.129458042,MN,Houston County,27055
4462,8202,12965,0.344157347,0.632626302,3740,0.288468955,MN,Hubbard County,27057
7138,16491,24235,0.294532701,0.680462142,9353,0.385929441,MN,Isanti County,27059
10786,15239,26561,0.406084108,0.573735929,4453,0.16765182,MN,Itasca County,27061
1745,3948,5819,0.299879704,0.678467091,2203,0.378587386,MN,Jackson County,27063
2774,6278,9242,0.300151482,0.679290197,3504,0.379138715,MN,Kanabec County,27065
8440,14437,23367,0.361193136,0.617837121,5997,0.256643985,MN,Kandiyohi County,27067
1006,1546,2639,0.381205002,0.585827965,540,0.204622963,MN,Kittson County,27069
2659,4131,6922,0.384137533,0.596792834,1472,0.212655302,MN,Koochiching County,27071
1446,2528,4040,0.357920792,0.625742574,1082,0.267821782,MN,Lac qui Parle County,27073
3647,3393,7202,0.506387115,0.471119134,-254,-0.035267981,MN,Lake County,27075
671,1704,2408,0.278654485,0.707641196,1033,0.428986711,MN,Lake of the Woods County,27077
5672,10775,16818,0.3372577,0.640682602,5103,0.303424902,MN,Le Sueur County,27079
937,2121,3115,0.300802568,0.680898876,1184,0.380096308,MN,Lincoln County,27081
4634,7979,12893,0.35941984,0.618862949,3345,0.259443109,MN,Lyon County,27083
6413,13986,20933,0.306358382,0.668131658,7573,0.361773277,MN,McLeod County,27085
1112,1142,2304,0.482638889,0.495659722,30,0.013020833,MN,Mahnomen County,27087
1295,3721,5113,0.253275963,0.727752787,2426,0.474476824,MN,Marshall County,27089
3305,7480,11009,0.30020892,0.679444091,4175,0.379235171,MN,Martin County,27091
3867,9359,13529,0.285830438,0.691773228,5492,0.40594279,MN,Meeker County,27093
4404,9952,14689,0.299816189,0.677513786,5548,0.377697597,MN,Mille Lacs County,27095
4367,14821,19558,0.223284589,0.757797321,10454,0.534512731,MN,Morrison County,27097
8899,10025,19345,0.460015508,0.518221763,1126,0.058206255,MN,Mower County,27099
1449,3363,4896,0.295955882,0.686887255,1914,0.390931373,MN,Murray County,27101
9622,9018,19125,0.503111111,0.471529412,-604,-0.031581699,MN,Nicollet County,27103
2933,5600,8715,0.336546185,0.642570281,2667,0.306024096,MN,Nobles County,27105
1404,1953,3441,0.408020924,0.567567568,549,0.159546643,MN,Norman County,27107
49491,39692,91385,0.541565903,0.434338239,-9799,-0.107227663,MN,Olmsted County,27109
11958,23800,36399,0.328525509,0.653864117,11842,0.325338608,MN,Otter Tail County,27111
2568,4532,7277,0.352892676,0.622784114,1964,0.269891439,MN,Pennington County,27113
5419,10256,16001,0.338666333,0.64095994,4837,0.302293607,MN,Pine County,27115
1306,3553,4940,0.26437247,0.719230769,2247,0.4548583,MN,Pipestone County,27117
5439,9865,15594,0.348787995,0.632615108,4426,0.283827113,MN,Polk County,27119
2477,4417,7022,0.352748505,0.62902307,1940,0.276274566,MN,Pope County,27121
211620,77376,295977,0.714987989,0.261425719,-134244,-0.45356227,MN,Ramsey County,27123
691,1454,2196,0.314663024,0.662112933,763,0.347449909,MN,Red Lake County,27125
2355,5771,8284,0.284282955,0.696644133,3416,0.412361178,MN,Redwood County,27127
2496,5467,8128,0.307086614,0.672613189,2971,0.365526575,MN,Renville County,27129
17402,17464,35686,0.487642213,0.489379589,62,0.001737376,MN,Rice County,27131
1556,3583,5240,0.296946565,0.683778626,2027,0.386832061,MN,Rock County,27133
2188,6065,8421,0.259826624,0.720223251,3877,0.460396627,MN,Roseau County,27135
67704,49017,119531,0.566413734,0.41007772,-18687,-0.156336013,MN,St. Louis County,27137
40040,45872,87965,0.455181038,0.521480134,5832,0.066299096,MN,Scott County,27139
18065,36222,55612,0.324839963,0.651334244,18157,0.326494282,MN,Sherburne County,27141
2417,5864,8451,0.286001657,0.693882381,3447,0.407880724,MN,Sibley County,27143
31879,50959,84835,0.375776507,0.60068368,19080,0.224907173,MN,Stearns County,27145
7917,12656,21128,0.374716017,0.599015524,4739,0.224299508,MN,Steele County,27147
1922,3044,5085,0.377974435,0.598623402,1122,0.220648968,MN,Stevens County,27149
1784,3316,5193,0.34353938,0.638551897,1532,0.295012517,MN,Swift County,27151
3286,9753,13257,0.24786905,0.735686807,6467,0.487817757,MN,Todd County,27153
661,1172,1864,0.354613734,0.628755365,511,0.274141631,MN,Traverse County,27155
4696,8153,13123,0.357845005,0.621275623,3457,0.263430618,MN,Wabasha County,27157
2023,5520,7677,0.263514394,0.719030871,3497,0.455516478,MN,Wadena County,27159
3496,6624,10389,0.33650977,0.637597459,3128,0.301087689,MN,Waseca County,27161
89165,73764,166786,0.534607221,0.442267337,-15401,-0.092339885,MN,Washington County,27163
1987,3103,5201,0.382041915,0.596616035,1116,0.21457412,MN,Watonwan County,27165
1026,2328,3430,0.299125364,0.678717201,1302,0.379591837,MN,Wilkin County,27167
13333,13227,27173,0.490670887,0.486769955,-106,-0.003900931,MN,Winona County,27169
28430,51973,82426,0.344915439,0.630541334,23543,0.285625895,MN,Wright County,27171
1688,3734,5528,0.305354559,0.675470333,2046,0.370115774,MN,Yellow Medicine County,27173
7917,5696,13759,0.575405189,0.413983574,-2221,-0.161421615,MS,Adams County,28001
2782,12818,15811,0.17595345,0.81070141,10036,0.63474796,MS,Alcorn County,28003
2620,4503,7207,0.363535452,0.624809213,1883,0.261273762,MS,Amite County,28005
3542,5178,8832,0.401041667,0.586277174,1636,0.185235507,MS,Attala County,28007
1679,2570,4292,0.391192917,0.598788444,891,0.207595527,MS,Benton County,28009
8904,4671,13755,0.647328244,0.339585605,-4233,-0.307742639,MS,Bolivar County,28011
1902,4625,6595,0.288400303,0.701288855,2723,0.412888552,MS,Calhoun County,28013
1729,3924,5705,0.303067485,0.687817704,2195,0.384750219,MS,Carroll County,28015
3810,4175,8148,0.467599411,0.51239568,365,0.044796269,MS,Chickasaw County,28017
1185,3001,4225,0.280473373,0.710295858,1816,0.429822485,MS,Choctaw County,28019
3772,603,4453,0.847069391,0.135414327,-3169,-0.711655064,MS,Claiborne County,28021
2838,5417,8347,0.340002396,0.64897568,2579,0.308973284,MS,Clarke County,28023
5844,4181,10206,0.57260435,0.409660984,-1663,-0.162943367,MS,Clay County,28025
6130,2400,8642,0.709326545,0.277713492,-3730,-0.431613053,MS,Coahoma County,28027
6470,6250,12897,0.501667054,0.484608824,-220,-0.017058231,MS,Copiah County,28029
3416,5854,9371,0.364528866,0.624693202,2438,0.260164337,MS,Covington County,28031
28265,46462,76248,0.370698248,0.609353688,18197,0.23865544,MS,DeSoto County,28033
13755,17290,31725,0.43356974,0.54499606,3535,0.11142632,MS,Forrest County,28035
1480,2923,4464,0.331541219,0.654793907,1443,0.323252688,MS,Franklin County,28037
1218,9713,11064,0.110086768,0.877892263,8495,0.767805495,MS,George County,28039
966,4794,5816,0.166093535,0.824277854,3828,0.658184319,MS,Greene County,28041
4734,6081,10919,0.433556186,0.556919132,1347,0.123362945,MS,Grenada County,28043
4504,16132,20957,0.214916257,0.769766665,11628,0.554850408,MS,Hancock County,28045
27728,46822,75865,0.365491333,0.617175246,19094,0.251683912,MS,Harrison County,28047
73550,25141,100191,0.734097873,0.250930722,-48409,-0.483167151,MS,Hinds County,28049
6588,1369,8115,0.811829945,0.168699938,-5219,-0.643130006,MS,Holmes County,28051
3016,1118,4189,0.719980902,0.266889472,-1898,-0.45309143,MS,Humphreys County,28053
355,308,676,0.525147929,0.455621302,-47,-0.069526627,MS,Issaquena County,28055
1249,9438,10826,0.115370405,0.871790135,8189,0.75641973,MS,Itawamba County,28057
17375,36295,54623,0.318089449,0.664463687,18920,0.346374238,MS,Jackson County,28059
4341,4302,8742,0.496568291,0.492107069,-39,-0.004461222,MS,Jasper County,28061
3327,531,3911,0.850677576,0.135770903,-2796,-0.714906673,MS,Jefferson County,28063
3599,2534,6213,0.579269274,0.407854499,-1065,-0.171414775,MS,Jefferson Davis County,28065
8517,21226,30091,0.283041441,0.705393639,12709,0.422352198,MS,Jones County,28067
2887,1787,4732,0.610101437,0.377641589,-1100,-0.232459848,MS,Kemper County,28069
10070,12949,23481,0.428857374,0.551467144,2879,0.12260977,MS,Lafayette County,28071
7340,20704,28526,0.257309122,0.725794012,13364,0.468484891,MS,Lamar County,28073
12960,17967,31266,0.414507772,0.574649779,5007,0.160142007,MS,Lauderdale County,28075
2260,4285,6617,0.341544507,0.647574429,2025,0.306029923,MS,Lawrence County,28077
3897,5228,9204,0.423402868,0.568013907,1331,0.144611039,MS,Leake County,28079
12189,24207,37003,0.329405724,0.654190201,12018,0.324784477,MS,Lee County,28081
7648,3129,10893,0.702102268,0.287248692,-4519,-0.414853576,MS,Leflore County,28083
5040,11596,16818,0.299678915,0.689499346,6556,0.38982043,MS,Lincoln County,28085
13087,13800,27273,0.479851868,0.50599494,713,0.026143072,MS,Lowndes County,28087
24440,31091,56335,0.433833319,0.551894914,6651,0.118061596,MS,Madison County,28089
3787,8273,12194,0.310562572,0.678448417,4486,0.367885845,MS,Marion County,28091
8057,7566,15830,0.50897031,0.477953253,-491,-0.031017056,MS,Marshall County,28093
5874,11177,17279,0.339950229,0.646854563,5303,0.306904335,MS,Monroe County,28095
2121,2917,5078,0.417684128,0.574438755,796,0.156754628,MS,Montgomery County,28097
3260,8320,11720,0.278156997,0.709897611,5060,0.431740614,MS,Neshoba County,28099
3075,6997,10189,0.301796055,0.686720974,3922,0.384924919,MS,Newton County,28101
4040,1240,5341,0.756412657,0.232166261,-2800,-0.524246396,MS,Noxubee County,28103
10299,9004,19812,0.519836463,0.454472037,-1295,-0.065364426,MS,Oktibbeha County,28105
7403,8060,15635,0.473488967,0.515510074,657,0.042021106,MS,Panola County,28107
4148,19595,24056,0.172430994,0.814557699,15447,0.642126704,MS,Pearl River County,28109
1362,4500,5922,0.229989868,0.759878419,3138,0.529888551,MS,Perry County,28111
8646,8479,17360,0.498041475,0.488421659,-167,-0.009619816,MS,Pike County,28113
2614,11550,14377,0.181818182,0.803366488,8936,0.621548306,MS,Pontotoc County,28115
2139,8312,10588,0.202021156,0.785039668,6173,0.583018512,MS,Prentiss County,28117
2150,1026,3229,0.665840818,0.317745432,-1124,-0.348095386,MS,Quitman County,28119
18847,50895,70655,0.266746869,0.720331187,32048,0.453584318,MS,Rankin County,28121
4330,6285,10744,0.403015637,0.584977662,1955,0.181962025,MS,Scott County,28123
1465,688,2183,0.671094824,0.31516262,-777,-0.355932203,MS,Sharkey County,28125
4037,7635,11820,0.341539763,0.645939086,3598,0.304399323,MS,Simpson County,28127
1791,6458,8327,0.215083463,0.775549418,4667,0.560465954,MS,Smith County,28129
1802,5964,7878,0.228738258,0.757044935,4162,0.528306677,MS,Stone County,28131
6781,2799,9683,0.700299494,0.289063307,-3982,-0.411236187,MS,Sunflower County,28133
3105,2488,5691,0.545598313,0.437181515,-617,-0.108416798,MS,Tallahatchie County,28135
4183,8707,13101,0.319288604,0.664605755,4524,0.345317151,MS,Tate County,28137
1937,8054,10102,0.191744209,0.797267868,6117,0.605523659,MS,Tippah County,28139
1059,7933,9147,0.115775664,0.867278889,6874,0.751503225,MS,Tishomingo County,28141
2580,926,3565,0.723702665,0.259747546,-1654,-0.463955119,MS,Tunica County,28143
2160,10373,12683,0.17030671,0.817866435,8213,0.647559726,MS,Union County,28145
2835,4220,7122,0.398062342,0.592530188,1385,0.194467846,MS,Walthall County,28147
10442,10365,21056,0.495915653,0.492258739,-77,-0.003656915,MS,Warren County,28149
12503,5300,18025,0.693647712,0.294036061,-7203,-0.39961165,MS,Washington County,28151
3624,6307,10065,0.360059613,0.626626925,2683,0.266567312,MS,Wayne County,28153
1043,4291,5402,0.193076638,0.794335431,3248,0.601258793,MS,Webster County,28155
2749,1324,4130,0.665617433,0.320581114,-1425,-0.34503632,MS,Wilkinson County,28157
4040,5112,9244,0.437040242,0.553007356,1072,0.115967114,MS,Winston County,28159
2785,3671,6538,0.425971245,0.561486693,886,0.135515448,MS,Yalobusha County,28161
5496,4832,10441,0.526386361,0.46279092,-664,-0.063595441,MS,Yazoo County,28163
3705,6391,10337,0.358421205,0.618264487,2686,0.259843281,MO,Adair County,29001
2351,7256,9775,0.240511509,0.74230179,4905,0.501790281,MO,Andrew County,29003
564,2199,2814,0.200426439,0.781449893,1635,0.581023454,MO,Atchison County,29005
2703,7727,10660,0.253564728,0.724859287,5024,0.471294559,MO,Audrain County,29007
2948,12425,15598,0.18899859,0.796576484,9477,0.607577895,MO,Barry County,29009
844,5168,6077,0.138884318,0.850419615,4324,0.711535297,MO,Barton County,29011
1672,6595,8435,0.198221695,0.781861292,4923,0.583639597,MO,Bates County,29013
2179,8106,10478,0.207959534,0.77362092,5927,0.565661386,MO,Benton County,29015
749,5162,5981,0.125229895,0.863066377,4413,0.737836482,MO,Bollinger County,29017
50064,38646,91326,0.548190001,0.423165364,-11418,-0.125024637,MO,Boone County,29019
13445,22450,36713,0.36621905,0.611500014,9005,0.245280963,MO,Buchanan County,29021
3301,14599,18165,0.181723094,0.803688412,11298,0.621965318,MO,Butler County,29023
897,3725,4696,0.191013629,0.793228279,2828,0.602214651,MO,Caldwell County,29025
5868,14812,21178,0.277079989,0.699405043,8944,0.422325054,MO,Callaway County,29027
5640,18825,24774,0.227658029,0.759869218,13185,0.532211189,MO,Camden County,29029
10738,28873,40252,0.266769353,0.717305972,18135,0.450536619,MO,Cape Girardeau County,29031
785,3706,4531,0.173250938,0.817920989,2921,0.644670051,MO,Carroll County,29033
418,2451,2906,0.14384033,0.843427392,2033,0.699587061,MO,Carter County,29035
19035,37172,57524,0.330905361,0.646199847,18137,0.315294486,MO,Cass County,29037
1143,5786,7039,0.16238102,0.82199176,4643,0.65961074,MO,Cedar County,29039
916,3109,4074,0.224840452,0.763132057,2193,0.538291605,MO,Chariton County,29041
11126,34904,46904,0.237207914,0.744158281,23778,0.506950367,MO,Christian County,29043
678,2672,3394,0.19976429,0.787271656,1994,0.587507366,MO,Clark County,29045
59519,64583,126618,0.470067447,0.510061761,5064,0.039994314,MO,Clay County,29047
2894,7789,10894,0.265650817,0.714980723,4895,0.449329906,MO,Clinton County,29049
12687,26066,39486,0.321303753,0.660132705,13379,0.338828952,MO,Cole County,29051
2249,6272,8710,0.258208955,0.720091848,4023,0.461882893,MO,Cooper County,29053
2113,8725,10973,0.192563565,0.79513351,6612,0.602569944,MO,Crawford County,29055
656,3414,4123,0.159107446,0.828037837,2758,0.66893039,MO,Dade County,29057
1380,6620,8122,0.169908889,0.81507018,5240,0.64516129,MO,Dallas County,29059
740,3077,3884,0.190525232,0.792224511,2337,0.601699279,MO,Daviess County,29061
930,3827,4842,0.192069393,0.790375878,2897,0.598306485,MO,DeKalb County,29063
1056,5987,7142,0.147857743,0.838280594,4931,0.690422851,MO,Dent County,29065
1012,5896,6994,0.144695453,0.843008293,4884,0.69831284,MO,Douglas County,29067
2200,8135,10419,0.211152702,0.780785104,5935,0.569632402,MO,Dunklin County,29069
14561,38034,53750,0.270902326,0.707609302,23473,0.436706977,MO,Franklin County,29071
1601,6222,7934,0.201789766,0.784219813,4621,0.582430048,MO,Gasconade County,29073
613,2580,3239,0.189255943,0.796542143,1967,0.607286199,MO,Gentry County,29075
55068,83630,142272,0.387061404,0.587817701,28562,0.200756298,MO,Greene County,29077
799,3585,4437,0.180076628,0.807978364,2786,0.627901735,MO,Grundy County,29079
597,3198,3825,0.156078431,0.836078431,2601,0.68,MO,Harrison County,29081
2615,8019,10776,0.242668894,0.744153675,5404,0.501484781,MO,Henry County,29083
1054,3965,5080,0.207480315,0.780511811,2911,0.573031496,MO,Hickory County,29085
338,1976,2344,0.144197952,0.843003413,1638,0.698805461,MO,Holt County,29087
1412,3552,5089,0.277461191,0.697976027,2140,0.420514836,MO,Howard County,29089
3214,15174,18637,0.172452648,0.814186833,11960,0.641734185,MO,Howell County,29091
945,3596,4592,0.205792683,0.783101045,2651,0.577308362,MO,Iron County,29093
199842,126535,334055,0.59823083,0.378784931,-73307,-0.2194459,MO,Jackson County,29095
13539,37714,52515,0.257812054,0.718156717,24175,0.460344663,MO,Jasper County,29097
37507,77021,116629,0.3215924,0.660393213,39514,0.338800813,MO,Jefferson County,29099
6961,15468,23134,0.30089911,0.668626264,8507,0.367727155,MO,Johnson County,29101
340,1486,1856,0.183189655,0.800646552,1146,0.617456897,MO,Knox County,29103
2779,13755,16819,0.1652298,0.817825079,10976,0.652595279,MO,Laclede County,29105
4470,12262,17083,0.261663642,0.717789615,7792,0.456125973,MO,Lafayette County,29107
3214,14421,17930,0.179252649,0.804294479,11207,0.625041829,MO,Lawrence County,29109
984,3541,4607,0.213588018,0.76861298,2557,0.555024962,MO,Lewis County,29111
6553,21702,28814,0.227424169,0.75317554,15149,0.525751371,MO,Lincoln County,29113
1274,4344,5700,0.223508772,0.762105263,3070,0.538596491,MO,Linn County,29115
1409,5266,6755,0.208586232,0.779570688,3857,0.570984456,MO,Livingston County,29117
1437,7465,9050,0.15878453,0.824861878,6028,0.666077348,MO,McDonald County,29119
1661,6075,7834,0.212024509,0.775465918,4414,0.563441409,MO,Macon County,29121
1017,4581,5671,0.179333451,0.80779404,3564,0.628460589,MO,Madison County,29123
814,3890,4774,0.170506912,0.814830331,3076,0.644323419,MO,Maries County,29125
3201,9910,13370,0.239416604,0.741211668,6709,0.501795064,MO,Marion County,29127
222,1541,1779,0.124789207,0.866216976,1319,0.741427768,MO,Mercer County,29129
2038,10175,12379,0.164633654,0.821956539,8137,0.657322886,MO,Miller County,29131
1178,3537,4756,0.247687132,0.743692178,2359,0.496005046,MO,Mississippi County,29133
1307,5738,7150,0.182797203,0.802517483,4431,0.61972028,MO,Moniteau County,29135
931,3466,4467,0.208417282,0.775912245,2535,0.567494963,MO,Monroe County,29137
1206,4457,5770,0.209012132,0.772443674,3251,0.563431542,MO,Montgomery County,29139
1924,7439,9484,0.202867988,0.784373682,5515,0.581505694,MO,Morgan County,29141
1748,5447,7248,0.241169978,0.75151766,3699,0.510347682,MO,New Madrid County,29143
5793,22090,28396,0.204007607,0.777926469,16297,0.573918862,MO,Newton County,29145
2849,6855,9874,0.288535548,0.694247519,4006,0.405711971,MO,Nodaway County,29147
823,3847,4742,0.173555462,0.811261071,3024,0.637705609,MO,Oregon County,29149
1031,6341,7449,0.13840784,0.851255202,5310,0.712847362,MO,Osage County,29151
752,4064,4870,0.154414784,0.83449692,3312,0.680082136,MO,Ozark County,29153
1556,4116,5727,0.271695478,0.718700891,2560,0.447005413,MO,Pemiscot County,29155
1661,7634,9429,0.176158659,0.809629865,5973,0.633471206,MO,Perry County,29157
4776,13835,19069,0.25045886,0.7255231,9059,0.47506424,MO,Pettis County,29159
5619,13438,19495,0.288227751,0.68930495,7819,0.401077199,MO,Phelps County,29161
1717,5856,7686,0.223393182,0.761904762,4139,0.538511579,MO,Pike County,29163
28111,29251,58523,0.480341062,0.499820583,1140,0.019479521,MO,Platte County,29165
2883,11849,15059,0.191446975,0.786838435,8966,0.59539146,MO,Polk County,29167
3735,10326,14405,0.25928497,0.716834432,6591,0.457549462,MO,Pulaski County,29169
361,1984,2361,0.152901313,0.840321898,1623,0.687420584,MO,Putnam County,29171
1205,4396,5662,0.212822324,0.776404097,3191,0.563581773,MO,Ralls County,29173
2485,8018,10742,0.231334947,0.746415937,5533,0.515080991,MO,Randolph County,29175
3107,8328,11654,0.266603741,0.714604428,5221,0.448000686,MO,Ray County,29177
529,2733,3298,0.160400243,0.828684051,2204,0.668283808,MO,Reynolds County,29179
833,4838,5743,0.145046143,0.842416855,4005,0.697370712,MO,Ripley County,29181
89346,128193,222175,0.402142455,0.576991111,38847,0.174848655,MO,St. Charles County,29183
988,3930,4972,0.198712792,0.790426388,2942,0.591713596,MO,St. Clair County,29185
2713,6627,9495,0.285729331,0.697946288,3914,0.412216956,MO,Ste. Genevieve County,29186
7044,20506,27996,0.251607372,0.73246178,13462,0.480854408,MO,St. Francois County,29187
328151,199493,536446,0.611713015,0.371878996,-128658,-0.239834019,MO,St. Louis County,29189
2903,6447,9528,0.30468094,0.67663728,3544,0.371956339,MO,Saline County,29195
373,1606,2005,0.186034913,0.800997506,1233,0.614962594,MO,Schuyler County,29197
387,1560,1985,0.194962217,0.785894207,1173,0.59093199,MO,Scotland County,29199
3753,13769,17748,0.211460446,0.775805725,10016,0.564345278,MO,Scott County,29201
706,3164,3908,0.180655067,0.80962129,2458,0.628966223,MO,Shannon County,29203
592,2699,3355,0.176453055,0.804470939,2107,0.628017884,MO,Shelby County,29205
1814,11460,13410,0.135272185,0.85458613,9646,0.719313945,MO,Stoddard County,29207
3506,14800,18520,0.189308855,0.799136069,11294,0.609827214,MO,Stone County,29209
478,1974,2471,0.19344395,0.798866856,1496,0.605422906,MO,Sullivan County,29211
5325,20426,26240,0.202934451,0.778429878,15101,0.575495427,MO,Taney County,29213
1716,9478,11332,0.15142958,0.836392517,7762,0.684962937,MO,Texas County,29215
1902,7135,9164,0.207551288,0.778590135,5233,0.571038848,MO,Vernon County,29217
4769,13222,18373,0.259565667,0.719642954,8453,0.460077287,MO,Warren County,29219
1804,8046,9971,0.180924682,0.806940126,6242,0.626015445,MO,Washington County,29221
844,4984,5874,0.143684031,0.848484848,4140,0.704800817,MO,Wayne County,29223
3572,14874,18776,0.190242863,0.792181508,11302,0.601938645,MO,Webster County,29225
215,877,1107,0.194218609,0.792231256,662,0.598012647,MO,Worth County,29227
1167,7452,8737,0.133569875,0.852924345,6285,0.719354469,MO,Wright County,29229
110089,21474,134372,0.819285268,0.159810079,-88615,-0.659475188,MO,St. Louis city,29510
1608,3923,5661,0.284048755,0.692987105,2315,0.40893835,MT,Beaverhead County,30001
2491,2207,4784,0.52069398,0.461329431,-284,-0.059364548,MT,Big Horn County,30003
1589,1469,3117,0.50978505,0.471286493,-120,-0.038498556,MT,Blaine County,30005
835,3173,4097,0.203807664,0.774469124,2338,0.57066146,MT,Broadwater County,30007
2421,4468,7101,0.340937896,0.629207154,2047,0.288269258,MT,Carbon County,30009
74,775,864,0.085648148,0.896990741,701,0.811342593,MT,Carter County,30011
15456,23315,39885,0.387514103,0.584555597,7859,0.197041494,MT,Cascade County,30013
991,1891,2974,0.333221251,0.635843981,900,0.30262273,MT,Chouteau County,30015
1514,4205,5883,0.257351691,0.714771375,2691,0.457419684,MT,Custer County,30017
195,799,1014,0.192307692,0.787968442,604,0.59566075,MT,Daniels County,30019
962,3758,4837,0.198883606,0.776927848,2796,0.578044242,MT,Dawson County,30021
2562,2186,4891,0.52381926,0.446943365,-376,-0.076875895,MT,Deer Lodge County,30023
172,1375,1575,0.109206349,0.873015873,1203,0.763809524,MT,Fallon County,30025
1496,4869,6531,0.229061399,0.74552136,3373,0.51645996,MT,Fergus County,30027
20274,38321,60258,0.336453251,0.635948754,18047,0.299495503,MT,Flathead County,30029
37044,31696,71507,0.518047184,0.443257303,-5348,-0.074789881,MT,Gallatin County,30031
41,764,813,0.050430504,0.939729397,723,0.889298893,MT,Garfield County,30033
3610,1884,5639,0.64018443,0.334101791,-1726,-0.306082639,MT,Glacier County,30035
78,414,503,0.155069583,0.82306163,336,0.667992048,MT,Golden Valley County,30037
638,1419,2102,0.303520457,0.675071361,781,0.371550904,MT,Granite County,30039
2981,3957,7182,0.415065441,0.550960735,976,0.135895294,MT,Hill County,30041
2625,5345,8191,0.320473691,0.652545477,2720,0.332071786,MT,Jefferson County,30043
275,1040,1344,0.204613095,0.773809524,765,0.569196429,MT,Judith Basin County,30045
6916,9322,16626,0.415974979,0.560688079,2406,0.1447131,MT,Lake County,30047
19743,21409,42485,0.46470519,0.50391903,1666,0.03921384,MT,Lewis and Clark County,30049
249,821,1083,0.229916898,0.758079409,572,0.528162512,MT,Liberty County,30051
2835,8672,11747,0.241338214,0.738231038,5837,0.496892824,MT,Lincoln County,30053
155,956,1128,0.137411348,0.84751773,801,0.710106383,MT,McCone County,30055
1771,4191,6113,0.289710453,0.685588091,2420,0.395877638,MT,Madison County,30057
258,833,1110,0.232432432,0.75045045,575,0.518018018,MT,Meagher County,30059
686,1828,2563,0.267655092,0.713226687,1142,0.445571596,MT,Mineral County,30061
43357,26347,71986,0.602297669,0.366001723,-17010,-0.236295946,MT,Missoula County,30063
413,2423,2881,0.143353002,0.841027421,2010,0.697674419,MT,Musselshell County,30065
5280,6025,11618,0.454467206,0.51859184,745,0.064124634,MT,Park County,30067
39,298,351,0.111111111,0.849002849,259,0.737891738,MT,Petroleum County,30069
416,1936,2386,0.174350377,0.811399832,1520,0.637049455,MT,Phillips County,30071
903,2031,2995,0.301502504,0.678130217,1128,0.376627713,MT,Pondera County,30073
154,970,1136,0.13556338,0.853873239,816,0.718309859,MT,Powder River County,30075
752,2355,3195,0.235367762,0.737089202,1603,0.50172144,MT,Powell County,30077
126,603,744,0.169354839,0.810483871,477,0.641129032,MT,Prairie County,30079
8763,19114,28507,0.307398183,0.670501982,10351,0.363103799,MT,Ravalli County,30081
875,4800,5798,0.150914108,0.82787168,3925,0.676957572,MT,Richland County,30083
1910,1996,4028,0.474180735,0.495531281,86,0.021350546,MT,Roosevelt County,30085
1199,2486,3784,0.316860465,0.656976744,1287,0.340116279,MT,Rosebud County,30087
1820,5660,7652,0.237846315,0.739675902,3840,0.501829587,MT,Sanders County,30089
574,1403,2030,0.282758621,0.691133005,829,0.408374384,MT,Sheridan County,30091
10392,7745,18827,0.55197323,0.411377277,-2647,-0.140595953,MT,Silver Bow County,30093
1156,4462,5741,0.201358648,0.777216513,3306,0.575857864,MT,Stillwater County,30095
549,1840,2446,0.224448078,0.752248569,1291,0.527800491,MT,Sweet Grass County,30097
1007,2608,3695,0.272530447,0.705818674,1601,0.433288227,MT,Teton County,30099
467,1596,2123,0.219971738,0.751766368,1129,0.53179463,MT,Toole County,30101
78,373,460,0.169565217,0.810869565,295,0.641304348,MT,Treasure County,30103
1030,3135,4272,0.241104869,0.733848315,2105,0.492743446,MT,Valley County,30105
225,823,1068,0.210674157,0.770599251,598,0.559925094,MT,Wheatland County,30107
77,516,598,0.128762542,0.862876254,439,0.734113712,MT,Wibaux County,30109
30679,50772,83821,0.366006132,0.60571933,20093,0.239713198,MT,Yellowstone County,30111
4213,10085,14602,0.28852212,0.690658814,5872,0.402136694,NE,Adams County,31001
452,3093,3583,0.12615127,0.863243092,2641,0.737091822,NE,Antelope County,31003
21,260,284,0.073943662,0.915492958,239,0.841549296,NE,Arthur County,31005
43,362,410,0.104878049,0.882926829,319,0.77804878,NE,Banner County,31007
35,280,317,0.110410095,0.883280757,245,0.772870662,NE,Blaine County,31009
499,2653,3217,0.15511346,0.82468138,2154,0.66956792,NE,Boone County,31011
1051,4002,5181,0.202856591,0.772437753,2951,0.569581162,NE,Box Butte County,31013
135,1010,1153,0.117085863,0.875975716,875,0.758889853,NE,Boyd County,31015
191,1470,1679,0.113758189,0.875521144,1279,0.761762954,NE,Brown County,31017
6350,16640,23589,0.269193268,0.70541354,10290,0.436220272,NE,Buffalo County,31019
1063,2580,3731,0.284910212,0.691503618,1517,0.406593407,NE,Burt County,31021
873,3542,4498,0.194086261,0.787461094,2669,0.593374833,NE,Butler County,31023
4737,10121,15284,0.309931955,0.66219576,5384,0.352263805,NE,Cass County,31025
725,4174,4996,0.145116093,0.835468375,3449,0.690352282,NE,Cedar County,31027
226,1740,1993,0.113396889,0.873055695,1514,0.759658806,NE,Chase County,31029
373,2844,3265,0.11424196,0.871056662,2471,0.756814701,NE,Cherry County,31031
855,3813,4765,0.179433368,0.800209864,2958,0.620776495,NE,Cheyenne County,31033
632,2848,3558,0.177627881,0.800449691,2216,0.62282181,NE,Clay County,31035
1025,2636,3726,0.275093935,0.707461084,1611,0.43236715,NE,Colfax County,31037
870,3507,4451,0.195461694,0.787912829,2637,0.592451135,NE,Cuming County,31039
786,5090,5993,0.131153012,0.849324212,4304,0.7181712,NE,Custer County,31041
2744,3926,6794,0.403885782,0.57786282,1182,0.173977039,NE,Dakota County,31043
1082,2931,4121,0.262557632,0.711235137,1849,0.448677505,NE,Dawes County,31045
2497,6524,9178,0.27206363,0.710830246,4027,0.438766616,NE,Dawson County,31047
141,871,1032,0.136627907,0.843992248,730,0.707364341,NE,Deuel County,31049
651,2335,3083,0.211157963,0.757379176,1684,0.546221213,NE,Dixon County,31051
5544,10984,16876,0.328513866,0.650865134,5440,0.322351268,NE,Dodge County,31053
150350,119159,274951,0.546824707,0.433382675,-31191,-0.113442031,NE,Douglas County,31055
105,883,999,0.105105105,0.883883884,778,0.778778779,NE,Dundy County,31057
693,2359,3134,0.221123165,0.752712189,1666,0.531589024,NE,Fillmore County,31059
276,1437,1724,0.160092807,0.833526682,1161,0.673433875,NE,Franklin County,31061
189,1229,1440,0.13125,0.853472222,1040,0.722222222,NE,Frontier County,31063
399,2163,2601,0.153402537,0.83160323,1764,0.678200692,NE,Furnas County,31065
3385,7445,11068,0.305836646,0.67265992,4060,0.366823274,NE,Gage County,31067
161,1016,1195,0.134728033,0.850209205,855,0.715481172,NE,Garden County,31069
133,933,1075,0.12372093,0.867906977,800,0.744186047,NE,Garfield County,31071
215,893,1118,0.192307692,0.798747764,678,0.606440072,NE,Gosper County,31073
20,375,402,0.049751244,0.932835821,355,0.883084577,NE,Grant County,31075
229,1016,1258,0.182034976,0.807631161,787,0.625596184,NE,Greeley County,31077
7681,16189,24374,0.315130877,0.664191351,8508,0.349060474,NE,Hall County,31079
1118,4309,5533,0.202060365,0.778781854,3191,0.576721489,NE,Hamilton County,31081
282,1615,1928,0.14626556,0.837655602,1333,0.691390041,NE,Harlan County,31083
34,494,534,0.063670412,0.925093633,460,0.861423221,NE,Hayes County,31085
175,1264,1469,0.119128659,0.860449285,1089,0.741320626,NE,Hitchcock County,31087
686,4769,5537,0.123893805,0.861296731,4083,0.737402926,NE,Holt County,31089
59,376,442,0.133484163,0.850678733,317,0.71719457,NE,Hooker County,31091
648,2786,3501,0.185089974,0.795772636,2138,0.610682662,NE,Howard County,31093
1016,2616,3716,0.273412271,0.703982777,1600,0.430570506,NE,Jefferson County,31095
647,1518,2229,0.290264693,0.68102288,871,0.390758188,NE,Johnson County,31097
701,2822,3604,0.194506104,0.783018868,2121,0.588512764,NE,Kearney County,31099
763,3544,4364,0.174839597,0.812098992,2781,0.637259395,NE,Keith County,31101
49,476,529,0.092627599,0.899810964,427,0.807183365,NE,Keya Paha County,31103
268,1563,1874,0.143009605,0.834044824,1295,0.691035219,NE,Kimball County,31105
905,3721,4697,0.192676176,0.792207792,2816,0.599531616,NE,Knox County,31107
82293,70092,156091,0.527211691,0.449045749,-12201,-0.078165942,NE,Lancaster County,31109
3692,13071,17107,0.215818086,0.764073186,9379,0.5482551,NE,Lincoln County,31111
38,407,450,0.084444444,0.904444444,369,0.82,NE,Logan County,31113
75,370,454,0.165198238,0.814977974,295,0.649779736,NE,Loup County,31115
17,275,302,0.056291391,0.910596026,258,0.854304636,NE,McPherson County,31117
3478,11940,15765,0.220615287,0.75737393,8462,0.536758643,NE,Madison County,31119
743,3419,4282,0.173517048,0.798458664,2676,0.624941616,NE,Merrick County,31121
386,2113,2558,0.15089914,0.826035966,1727,0.675136826,NE,Morrill County,31123
359,1437,1828,0.196389497,0.786105033,1078,0.589715536,NE,Nance County,31125
921,2428,3423,0.269062226,0.709319311,1507,0.440257084,NE,Nemaha County,31127
409,1857,2303,0.177594442,0.806339557,1448,0.628745115,NE,Nuckolls County,31129
2490,5649,8315,0.299458809,0.679374624,3159,0.379915815,NE,Otoe County,31131
322,1071,1429,0.2253324,0.749475157,749,0.524142757,NE,Pawnee County,31133
199,1321,1544,0.12888601,0.855569948,1122,0.726683938,NE,Perkins County,31135
752,4157,5009,0.150129766,0.829906169,3405,0.679776402,NE,Phelps County,31137
480,3462,4006,0.11982027,0.864203694,2982,0.744383425,NE,Pierce County,31139
3260,12186,15673,0.208001021,0.777515472,8926,0.569514452,NE,Platte County,31141
530,2291,2879,0.184091699,0.795762418,1761,0.611670719,NE,Polk County,31143
811,4525,5452,0.148752751,0.829970653,3714,0.681217902,NE,Red Willow County,31145
996,3073,4126,0.241396025,0.744789142,2077,0.503393117,NE,Richardson County,31147
84,744,841,0.099881094,0.884661118,660,0.784780024,NE,Rock County,31149
1986,3631,5770,0.344194107,0.629289428,1645,0.285095321,NE,Saline County,31151
41206,51979,96193,0.428367969,0.540361565,10773,0.111993596,NE,Sarpy County,31153
3331,9108,12735,0.261562623,0.715194346,5777,0.453631724,NE,Saunders County,31155
4196,10952,15469,0.271252182,0.707996638,6756,0.436744457,NE,Scotts Bluff County,31157
2438,6490,9142,0.266681251,0.709910304,4052,0.443229053,NE,Seward County,31159
340,2292,2672,0.127245509,0.857784431,1952,0.730538922,NE,Sheridan County,31161
343,1322,1698,0.202002356,0.778563015,979,0.57656066,NE,Sherman County,31163
72,642,729,0.098765432,0.880658436,570,0.781893004,NE,Sioux County,31165
532,2561,3165,0.168088468,0.809162717,2029,0.64107425,NE,Stanton County,31167
624,2308,2980,0.209395973,0.774496644,1684,0.565100671,NE,Thayer County,31169
45,377,427,0.105386417,0.882903981,332,0.777517564,NE,Thomas County,31171
1122,1180,2325,0.482580645,0.507526882,58,0.024946237,NE,Thurston County,31173
412,1901,2340,0.176068376,0.812393162,1489,0.636324786,NE,Valley County,31175
3554,8583,12413,0.286312737,0.691452509,5029,0.405139773,NE,Washington County,31177
1022,3055,4200,0.243333333,0.727380952,2033,0.484047619,NE,Wayne County,31179
335,1511,1876,0.178571429,0.8054371,1176,0.626865672,NE,Webster County,31181
59,438,502,0.11752988,0.87250996,379,0.75498008,NE,Wheeler County,31183
1630,5337,7143,0.228195436,0.747165057,3707,0.518969621,NE,York County,31185
3051,9372,12890,0.236695112,0.727075252,6321,0.49038014,NV,Churchill County,32001
521852,430930,972510,0.536603223,0.443111125,-90922,-0.093492098,NV,Clark County,32003
11571,21630,34125,0.339076923,0.633846154,10059,0.294769231,NV,Douglas County,32005
4557,16741,21967,0.207447535,0.762097692,12184,0.554650157,NV,Elko County,32007
74,400,487,0.151950719,0.821355236,326,0.669404517,NV,Esmeralda County,32009
105,895,1017,0.103244838,0.880039331,790,0.776794494,NV,Eureka County,32011
1689,5877,7771,0.217346545,0.756273324,4188,0.538926779,NV,Humboldt County,32013
496,2198,2765,0.179385172,0.794936709,1702,0.615551537,NV,Lander County,32015
330,2067,2446,0.134914146,0.845053148,1737,0.710139002,NV,Lincoln County,32017
8473,20914,30238,0.280210331,0.691646273,12441,0.411435942,NV,Lyon County,32019
829,1423,2335,0.35503212,0.609421842,594,0.254389722,NV,Mineral County,32021
7288,17528,25378,0.287177871,0.690676964,10240,0.403499094,NV,Nye County,32023
547,1731,2320,0.235775862,0.74612069,1184,0.510344828,NV,Pershing County,32027
902,1908,2877,0.313521029,0.663190824,1006,0.349669795,NV,Storey County,32029
128128,116760,252142,0.508158101,0.463072396,-11368,-0.045085706,NV,Washoe County,32031
859,3403,4369,0.196612497,0.778896773,2544,0.582284276,NV,White Pine County,32033
12735,16113,29739,0.428225562,0.54181378,3378,0.113588217,NV,Carson City,32510
16894,20899,38453,0.439341534,0.543494656,4005,0.104153122,NH,Belknap County,33001
16649,16150,33272,0.500390719,0.485393123,-499,-0.014997596,NH,Carroll County,33003
25506,17892,44206,0.5769805,0.404741438,-7614,-0.172239063,NH,Cheshire County,33005
7640,8617,16528,0.462245886,0.521357696,977,0.05911181,NH,Coos County,33007
33180,19905,53989,0.614569635,0.368686214,-13275,-0.245883421,NH,Grafton County,33009
122344,104625,231040,0.529536011,0.452843663,-17719,-0.076692348,NH,Hillsborough County,33011
48533,39711,89887,0.539933472,0.441788023,-8822,-0.098145449,NH,Merrimack County,33013
100064,95858,198943,0.50297824,0.481836506,-4206,-0.021141734,NH,Rockingham County,33015
41721,30489,73729,0.565869604,0.41352792,-11232,-0.152341684,NH,Strafford County,33017
12390,11508,24383,0.508140918,0.471968175,-882,-0.036172743,NH,Sullivan County,33019
73624,64326,140141,0.525356605,0.459009141,-9298,-0.066347464,NJ,Atlantic County,34001
285811,204277,497160,0.57488736,0.410887843,-81534,-0.163999517,NJ,Bergen County,34003
154577,103326,265967,0.581188644,0.388491805,-51251,-0.192696838,NJ,Burlington County,34005
174575,86024,264912,0.65899242,0.324726702,-88551,-0.334265718,NJ,Camden County,34007
23941,33158,57933,0.413253241,0.572350819,9217,0.159097578,NJ,Cape May County,34009
32742,28952,62575,0.523244107,0.462676788,-3790,-0.060567319,NJ,Cumberland County,34011
266820,75475,345311,0.772694759,0.218571085,-191345,-0.554123674,NJ,Essex County,34013
86702,83340,173453,0.499858751,0.480475979,-3362,-0.019382772,NJ,Gloucester County,34015
181452,65698,250458,0.724480751,0.262311445,-115754,-0.462169306,NJ,Hudson County,34017
39457,43153,84673,0.465992701,0.509642979,3696,0.043650278,NJ,Hunterdon County,34019
122532,51461,177069,0.692001423,0.290626818,-71071,-0.401374605,NJ,Mercer County,34021
226245,143461,375681,0.602226357,0.381869192,-82784,-0.220357165,NJ,Middlesex County,34023
181291,191808,378390,0.479111499,0.506905574,10517,0.027794075,NJ,Monmouth County,34025
153881,141134,300917,0.511373568,0.46901305,-12747,-0.042360518,NJ,Morris County,34027
119456,217740,342746,0.348526314,0.635280937,98284,0.286754623,NJ,Ocean County,34029
129097,92009,224330,0.57547809,0.410150225,-37088,-0.165327865,NJ,Passaic County,34031
14452,18781,33969,0.425446731,0.552886455,4329,0.127439724,NJ,Salem County,34033
111113,71994,186826,0.594740561,0.385353216,-39119,-0.209387344,NJ,Somerset County,34035
34417,51566,88148,0.390445614,0.58499342,17149,0.194547806,NJ,Sussex County,34037
170245,80002,254041,0.670147732,0.314917671,-90243,-0.355230061,NJ,Union County,34039
24901,34769,61057,0.407832026,0.569451496,9868,0.16161947,NJ,Warren County,34041
193757,116135,317590,0.61008533,0.365675871,-77622,-0.244409459,NM,Bernalillo County,35001
595,1698,2326,0.255803955,0.730008598,1103,0.474204643,NM,Catron County,35003
6381,15656,22443,0.284320278,0.697589449,9275,0.413269171,NM,Chaves County,35005
4745,3975,8903,0.532966416,0.446478715,-770,-0.086487701,NM,Cibola County,35006
2611,3271,6016,0.434009309,0.543716755,660,0.109707447,NM,Colfax County,35007
4307,10444,15101,0.2852129,0.691609827,6137,0.406396927,NM,Curry County,35009
231,656,901,0.256381798,0.728079911,425,0.471698113,NM,De Baca County,35011
47957,32802,82641,0.580305175,0.396921625,-15155,-0.183383551,NM,DoÃ±a Ana County,35013
5424,17454,23222,0.233571613,0.751614848,12030,0.518043235,NM,Eddy County,35015
7590,6553,14435,0.525805334,0.453966055,-1037,-0.07183928,NM,Grant County,35017
1234,917,2189,0.56372773,0.418912746,-317,-0.144814984,NM,Guadalupe County,35019
179,319,505,0.354455446,0.631683168,140,0.277227723,NM,Harding County,35021
823,1120,1974,0.416919959,0.567375887,297,0.150455927,NM,Hidalgo County,35023
4061,16531,20918,0.194139019,0.790276317,12470,0.596137298,NM,Lea County,35025
3194,6942,10306,0.309916553,0.673588201,3748,0.363671648,NM,Lincoln County,35027
7554,4278,12293,0.614496055,0.348002928,-3276,-0.266493126,NM,Los Alamos County,35028
3563,4408,8103,0.439713686,0.543996051,845,0.104282365,NM,Luna County,35029
18029,7801,26486,0.680699237,0.294532961,-10228,-0.386166277,NM,McKinley County,35031
1745,903,2686,0.649664929,0.33618764,-842,-0.31347729,NM,Mora County,35033
8485,14521,23571,0.359976242,0.616053625,6036,0.256077383,NM,Otero County,35035
1170,2634,3873,0.302091402,0.680092951,1464,0.378001549,NM,Quay County,35037
10990,5408,16628,0.660933365,0.325234544,-5582,-0.335698821,NM,Rio Arriba County,35039
1802,4634,6608,0.272699758,0.701271186,2832,0.428571429,NM,Roosevelt County,35041
40588,34174,76562,0.530132442,0.446357201,-6414,-0.083775241,NM,Sandoval County,35043
18083,32874,52294,0.345794929,0.628638085,14791,0.282843156,NM,San Juan County,35045
7888,3421,11531,0.684069031,0.296678519,-4467,-0.387390513,NM,San Miguel County,35047
62530,18329,82227,0.760455811,0.222907318,-44201,-0.537548494,NM,Santa Fe County,35049
2265,3542,5945,0.380992431,0.595794786,1277,0.214802355,NM,Sierra County,35051
3722,3255,7160,0.519832402,0.454608939,-467,-0.065223464,NM,Socorro County,35053
13121,3715,17181,0.763692451,0.216227228,-9406,-0.547465223,NM,Taos County,35055
2344,4772,7281,0.3219338,0.655404477,2428,0.333470677,NM,Torrance County,35057
383,1388,1789,0.214086082,0.775852432,1005,0.56176635,NM,Union County,35059
14263,17364,32277,0.441893608,0.537968213,3101,0.096074604,NM,Valencia County,35061
73189,45570,121529,0.602234858,0.374972229,-27619,-0.227262629,NY,Albany County,36001
6048,14135,20782,0.291021076,0.680155904,8087,0.389134828,NY,Allegany County,36003
271835,55849,329638,0.824647037,0.169425248,-215986,-0.655221789,NY,Bronx County,36005
46909,43728,92853,0.505196386,0.470937934,-3181,-0.034258452,NY,Broome County,36007
11879,22155,34845,0.340909743,0.635815755,10276,0.294906012,NY,Cattaraugus County,36009
16143,19495,36433,0.443087311,0.535091812,3352,0.092004501,NY,Cayuga County,36011
23087,34853,59304,0.389299204,0.587700661,11766,0.198401457,NY,Chautauqua County,36013
16636,21922,39410,0.422126364,0.556254758,5286,0.134128394,NY,Chemung County,36015
8251,13464,22269,0.370515066,0.604607302,5213,0.234092236,NY,Chenango County,36017
12690,14354,27471,0.461941684,0.522514652,1664,0.060572968,NY,Clinton County,36019
20253,14453,35363,0.572717247,0.408704013,-5800,-0.164013234,NY,Columbia County,36021
10367,10788,21675,0.478292964,0.497716263,421,0.019423299,NY,Cortland County,36023
6420,11952,18763,0.342162767,0.636998348,5532,0.294835581,NY,Delaware County,36025
57720,59661,119539,0.482854968,0.499092346,1941,0.016237379,NY,Dutchess County,36027
198808,178349,383952,0.517793891,0.464508584,-20459,-0.053285306,NY,Erie County,36029
9947,8976,19259,0.516485799,0.466067812,-971,-0.050417986,NY,Essex County,36031
6586,8530,15397,0.427745665,0.554004027,1944,0.126258362,NY,Franklin County,36033
5804,13989,20180,0.287611497,0.6932111,8185,0.405599604,NY,Fulton County,36035
9625,18876,29204,0.32957814,0.646349815,9251,0.316771675,NY,Genesee County,36037
7675,12722,20882,0.367541423,0.609232832,5047,0.241691409,NY,Greene County,36039
1178,2225,3460,0.340462428,0.643063584,1047,0.302601156,NY,Hamilton County,36041
7282,17038,24766,0.294032141,0.687959299,9756,0.393927158,NY,Herkimer County,36043
17307,25629,43848,0.394704433,0.584496442,8322,0.189792009,NY,Jefferson County,36045
514133,174731,693937,0.740892905,0.251796633,-339402,-0.489096272,NY,Kings County,36047
3823,8890,12964,0.294893551,0.68574514,5067,0.390851589,NY,Lewis County,36049
12477,18182,31401,0.397344034,0.579026146,5705,0.181682112,NY,Livingston County,36051
14785,18402,34087,0.433743069,0.539853903,3617,0.106110834,NY,Madison County,36053
223936,145290,378761,0.591232994,0.38359282,-78646,-0.207640174,NY,Monroe County,36055
5746,11500,17615,0.326199262,0.652852682,5754,0.32665342,NY,Montgomery County,36057
392034,324858,726335,0.539742681,0.447256431,-67176,-0.092486249,NY,Nassau County,36059
377605,65001,446861,0.845016683,0.14546134,-312604,-0.699555343,NY,New York County,36061
34809,51355,87821,0.396363057,0.584769019,16546,0.188405962,NY,Niagara County,36063
30542,51950,84273,0.362417382,0.616448922,21408,0.25403154,NY,Oneida County,36065
116031,84743,206105,0.562970331,0.411164212,-31288,-0.151806118,NY,Onondaga County,36067
20779,25757,47830,0.434434455,0.538511395,4978,0.104076939,NY,Ontario County,36069
61868,76218,139956,0.442053217,0.544585441,14350,0.102532224,NY,Orange County,36071
5587,12126,18154,0.307755866,0.667951967,6539,0.3601961,NY,Orleans County,36073
20824,31677,53787,0.387156748,0.588934129,10853,0.201777381,NY,Oswego County,36075
12986,14366,28075,0.46254675,0.511700801,1380,0.049154052,NY,Otsego County,36077
24949,29277,55110,0.452712756,0.531246598,4328,0.078533841,NY,Putnam County,36079
412393,181225,597928,0.689703443,0.303088332,-231168,-0.386615111,NY,Queens County,36081
40969,36500,79409,0.515923888,0.459645632,-4469,-0.056278256,NY,Rensselaer County,36083
67223,110094,178751,0.376070623,0.615907044,42871,0.23983642,NY,Richmond County,36085
75791,73180,150685,0.502976408,0.48564887,-2611,-0.017327538,NY,Rockland County,36087
19361,24608,44907,0.431135458,0.54797693,5247,0.116841472,NY,St. Lawrence County,36089
68471,61305,132655,0.516158456,0.46213863,-7166,-0.054019826,NY,Saratoga County,36091
31685,27544,60591,0.522932449,0.454588965,-4141,-0.068343483,NY,Schenectady County,36093
5345,9903,15710,0.340229153,0.630362826,4558,0.290133673,NY,Schoharie County,36095
3903,5621,9766,0.399651853,0.575568298,1718,0.175916445,NY,Schuyler County,36097
6914,8329,15630,0.442354447,0.532885477,1415,0.09053103,NY,Seneca County,36099
11299,26781,38797,0.291233858,0.690285331,15482,0.399051473,NY,Steuben County,36101
259463,333617,601261,0.431531398,0.554862198,74154,0.1233308,NY,Suffolk County,36103
10995,15555,26931,0.408265568,0.577587167,4560,0.1693216,NY,Sullivan County,36105
9498,14616,24769,0.3834632,0.590092454,5118,0.206629254,NY,Tioga County,36107
22627,9644,33142,0.682728864,0.290990284,-12983,-0.391738579,NY,Tompkins County,36109
42606,33580,77667,0.548572753,0.432358659,-9026,-0.116214094,NY,Ulster County,36111
17642,17699,36131,0.488278763,0.489856356,57,0.001577593,NY,Warren County,36113
8537,14577,23607,0.361630025,0.617486339,6040,0.255856314,NY,Washington County,36115
12799,23734,37425,0.341990648,0.634175017,10935,0.292184369,NY,Wayne County,36117
220963,126013,350749,0.629974711,0.359268309,-94950,-0.270706403,NY,Westchester County,36119
5073,13897,19431,0.261077659,0.715197365,8824,0.454119706,NY,Wyoming County,36121
4217,6208,10741,0.392607765,0.577972256,1991,0.185364491,NY,Yates County,36123
38825,46056,86091,0.450976293,0.534968812,7231,0.08399252,NC,Alamance County,37001
4145,15888,20236,0.204832971,0.785135402,11743,0.580302431,NC,Alexander County,37003
1486,4527,6076,0.244568795,0.745062541,3041,0.500493746,NC,Alleghany County,37005
5789,5321,11194,0.517152046,0.475343934,-468,-0.041808111,NC,Anson County,37007
4164,11451,15814,0.26331099,0.724105223,7287,0.460794233,NC,Ashe County,37009
2191,7172,9458,0.231655741,0.758299852,4981,0.526644111,NC,Avery County,37011
9633,16437,26315,0.366064982,0.624624739,6804,0.258559757,NC,Beaufort County,37013
5939,3817,9815,0.605094244,0.388894549,-2122,-0.216199694,NC,Bertie County,37015
7326,9676,17125,0.42779562,0.565021898,2350,0.137226277,NC,Bladen County,37017
33310,55850,90175,0.369392847,0.619351261,22540,0.249958414,NC,Brunswick County,37019
96515,62412,161569,0.59736088,0.386286973,-34103,-0.211073907,NC,Buncombe County,37021
13118,31019,44602,0.294112372,0.695462087,17901,0.401349715,NC,Burke County,37023
52162,63237,117227,0.44496575,0.539440573,11075,0.094474822,NC,Cabarrus County,37025
10245,32119,42829,0.239207079,0.749935791,21874,0.510728712,NC,Caldwell County,37027
1537,4312,5953,0.258189148,0.724340669,2775,0.46615152,NC,Camden County,37029
12093,30028,42695,0.283241597,0.703314205,17935,0.420072608,NC,Carteret County,37031
4860,7089,12051,0.403286034,0.588249938,2229,0.184963903,NC,Caswell County,37033
25689,56588,83425,0.307929278,0.678309859,30899,0.370380581,NC,Catawba County,37035
26787,21186,48599,0.551184181,0.435934896,-5601,-0.115249285,NC,Chatham County,37037
3583,12628,16423,0.21816964,0.768921634,9045,0.550751994,NC,Cherokee County,37039
3247,4471,7784,0.417137718,0.57438335,1224,0.157245632,NC,Chowan County,37041
1699,5112,6893,0.246481938,0.741621935,3413,0.495139997,NC,Clay County,37043
16955,33798,51308,0.33045529,0.658727684,16843,0.328272394,NC,Cleveland County,37045
9446,16832,26446,0.35718067,0.636466762,7386,0.279286092,NC,Columbus County,37047
21148,31032,53065,0.398530105,0.584792236,9884,0.186262131,NC,Craven County,37049
84469,60032,147150,0.574033299,0.407964662,-24437,-0.166068637,NC,Cumberland County,37051
4195,11657,16147,0.259800582,0.72192977,7462,0.462129188,NC,Currituck County,37053
9936,13938,24232,0.410036316,0.575189832,4002,0.165153516,NC,Dare County,37055
22636,64658,88514,0.255733556,0.730483313,42022,0.474749757,NC,Davidson County,37057
6713,18228,25311,0.265220655,0.720161195,11515,0.45494054,NC,Davie County,37059
8767,13793,22715,0.385956416,0.607219899,5026,0.221263482,NC,Duplin County,37061
144688,32459,179914,0.804206454,0.180413976,-112229,-0.623792479,NC,Durham County,37063
16089,9206,25477,0.631510774,0.361345527,-6883,-0.270165247,NC,Edgecombe County,37065
113029,85060,201262,0.561601296,0.422633185,-27969,-0.138968111,NC,Forsyth County,37067
15882,20904,37357,0.425141205,0.559573842,5022,0.134432636,NC,Franklin County,37069
40959,73033,115498,0.354629517,0.632331296,32074,0.277701778,NC,Gaston County,37071
2546,3367,5971,0.426394239,0.563892145,821,0.137497907,NC,Gates County,37073
905,3710,4665,0.193997856,0.79528403,2805,0.601286174,NC,Graham County,37075
14565,16647,31598,0.460946895,0.526837142,2082,0.065890246,NC,Granville County,37077
3832,4874,8753,0.437792757,0.556837656,1042,0.119044899,NC,Greene County,37079
173086,107294,284486,0.608416583,0.377150369,-65792,-0.231266213,NC,Guilford County,37081
15545,10080,25759,0.603478396,0.391319539,-5465,-0.212158857,NC,Halifax County,37083
22093,35177,58293,0.378999194,0.603451529,13084,0.224452336,NC,Harnett County,37085
13144,22834,36542,0.359695693,0.624870013,9690,0.26517432,NC,Haywood County,37087
27211,40032,68371,0.397990376,0.585511401,12821,0.187521025,NC,Henderson County,37089
7097,3479,10634,0.667387625,0.327158172,-3618,-0.340229453,NC,Hertford County,37091
11804,9453,21639,0.545496557,0.436850132,-2351,-0.108646425,NC,Hoke County,37093
1046,1418,2492,0.419743178,0.569020867,372,0.149277689,NC,Hyde County,37095
33888,67010,102371,0.331031249,0.65457991,33122,0.323548661,NC,Iredell County,37097
9591,11356,21428,0.447591936,0.529960799,1765,0.082368863,NC,Jackson County,37099
41261,68354,111362,0.370512383,0.61380004,27093,0.243287656,NC,Johnston County,37101
2197,3280,5525,0.397647059,0.593665158,1083,0.1960181,NC,Jones County,37103
12143,16469,29008,0.41860866,0.567739934,4326,0.149131274,NC,Lee County,37105
13605,14590,28409,0.478897532,0.513569643,985,0.034672111,NC,Lenoir County,37107
13274,36341,50217,0.264332796,0.723679232,23067,0.459346436,NC,Lincoln County,37109
5832,16883,23003,0.253532148,0.733947746,11051,0.480415598,NC,McDowell County,37111
6230,14211,20743,0.300342284,0.685098587,7981,0.384756303,NC,Macon County,37113
4901,7979,13076,0.37480881,0.610201897,3078,0.235393087,NC,Madison County,37115
5911,6532,12540,0.471371611,0.520893142,621,0.049521531,NC,Martin County,37117
378107,179211,567053,0.666793051,0.316039241,-198896,-0.35075381,NC,Mecklenburg County,37119
1867,7090,9041,0.206503705,0.784205287,5223,0.577701582,NC,Mitchell County,37121
4327,8411,12849,0.336757724,0.654603471,4084,0.317845747,NC,Montgomery County,37123
20779,36764,58339,0.356176829,0.630178783,15985,0.274001954,NC,Moore County,37125
25947,25827,52271,0.496393794,0.494098066,-120,-0.002295728,NC,Nash County,37127
66146,63333,131840,0.501714199,0.480377731,-2813,-0.021336468,NC,New Hanover County,37129
6069,3989,10109,0.600356118,0.394598872,-2080,-0.205757246,NC,Northampton County,37131
24266,46078,72235,0.335931335,0.637890219,21812,0.301958884,NC,Onslow County,37133
63594,20176,84997,0.748191113,0.237373084,-43418,-0.510818029,NC,Orange County,37135
2713,4849,7631,0.355523522,0.635434412,2136,0.27991089,NC,Pamlico County,37137
9832,9770,19897,0.494144846,0.491028798,-62,-0.003116048,NC,Pasquotank County,37139
11723,21956,34169,0.343088765,0.642570751,10233,0.299481987,NC,Pender County,37141
2492,4903,7484,0.332977018,0.655130946,2411,0.322153928,NC,Perquimans County,37143
8465,13184,21894,0.386635608,0.602174112,4719,0.215538504,NC,Person County,37145
47252,38982,87573,0.539572699,0.4451372,-8270,-0.0944355,NC,Pitt County,37147
4518,7689,12358,0.365593138,0.622188056,3171,0.256594918,NC,Polk County,37149
15618,56894,73316,0.213023078,0.776010693,41276,0.562987615,NC,Randolph County,37151
8754,11830,20763,0.421615374,0.569763522,3076,0.148148148,NC,Richmond County,37153
19020,27806,47188,0.403068577,0.589259981,8786,0.186191405,NC,Robeson County,37155
15992,31301,47809,0.334497689,0.654709364,15309,0.320211676,NC,Rockingham County,37157
23114,49297,73408,0.314870314,0.67154806,26183,0.356677746,NC,Rowan County,37159
9135,24891,34429,0.265328647,0.722966104,15756,0.457637457,NC,Rutherford County,37161
10966,17411,28618,0.383185408,0.608393319,6445,0.225207911,NC,Sampson County,37163
7186,7473,14775,0.486362098,0.505786802,287,0.019424704,NC,Scotland County,37165
8129,25458,33939,0.239517959,0.750110492,17329,0.510592534,NC,Stanly County,37167
5286,20143,25702,0.205664929,0.78371333,14857,0.578048401,NC,Stokes County,37169
8721,27538,36638,0.238031552,0.751623997,18817,0.513592445,NC,Surry County,37171
2780,4161,7068,0.393322015,0.588709677,1381,0.195387663,NC,Swain County,37173
8444,11636,20404,0.413840423,0.570280337,3192,0.156439914,NC,Transylvania County,37175
758,1044,1817,0.417171161,0.574573473,286,0.157402312,NC,Tyrrell County,37177
48725,80382,131011,0.371915335,0.613551534,31657,0.241636198,NC,Union County,37179
12431,8391,20999,0.591980571,0.399590457,-4040,-0.192390114,NC,Vance County,37181
393336,226197,631830,0.622534543,0.358002944,-167139,-0.264531599,NC,Wake County,37183
6400,3752,10293,0.621781793,0.364519576,-2648,-0.257262217,NC,Warren County,37185
3396,2781,6205,0.547300564,0.448186946,-615,-0.099113618,NC,Washington County,37187
17122,14451,32220,0.531409063,0.448510242,-2671,-0.082898821,NC,Watauga County,37189
24215,30709,55537,0.436015629,0.552946684,6494,0.116931055,NC,Wayne County,37191
7510,27591,35464,0.211764042,0.778000226,20081,0.566236183,NC,Wilkes County,37193
20754,19581,40735,0.509488155,0.480692279,-1173,-0.028795876,NC,Wilson County,37195
3763,15933,19923,0.188877177,0.799728956,12170,0.610851779,NC,Yadkin County,37197
3688,7516,11352,0.324876674,0.662085976,3828,0.337209302,NC,Yancey County,37199
258,981,1269,0.203309693,0.773049645,723,0.569739953,ND,Adams County,38001
1820,3568,5565,0.327044025,0.641150045,1748,0.31410602,ND,Barnes County,38003
822,1094,1961,0.419173891,0.557878633,272,0.138704742,ND,Benson County,38005
72,541,635,0.113385827,0.851968504,469,0.738582677,ND,Billings County,38007
821,2575,3471,0.236531259,0.741861135,1754,0.505329876,ND,Bottineau County,38009
228,1395,1657,0.137598069,0.841882921,1167,0.704284852,ND,Bowman County,38011
137,994,1155,0.118614719,0.860606061,857,0.741991342,ND,Burke County,38013
14348,34744,50753,0.2827025,0.68457037,20396,0.40186787,ND,Burleigh County,38015
40311,42619,86053,0.468443866,0.495264546,2308,0.02682068,ND,Cass County,38017
474,1499,2020,0.234653465,0.742079208,1025,0.507425743,ND,Cavalier County,38019
608,1742,2424,0.250825083,0.718646865,1134,0.467821782,ND,Dickey County,38021
265,904,1202,0.22046589,0.752079867,639,0.531613977,ND,Divide County,38023
342,1951,2338,0.146278871,0.834473909,1609,0.688195038,ND,Dunn County,38025
383,854,1261,0.303727201,0.677240285,471,0.373513085,ND,Eddy County,38027
237,1738,2009,0.117969139,0.865107018,1501,0.74713788,ND,Emmons County,38029
373,1362,1778,0.209786277,0.766029246,989,0.55624297,ND,Foster County,38031
137,871,1026,0.133528265,0.848927875,734,0.71539961,ND,Golden Valley County,38033
12880,16987,30970,0.415886342,0.548498547,4107,0.132612205,ND,Grand Forks County,38035
207,1145,1381,0.149891383,0.829109341,938,0.679217958,ND,Grant County,38037
308,907,1250,0.2464,0.7256,599,0.4792,ND,Griggs County,38039
196,1091,1312,0.149390244,0.831554878,895,0.682164634,ND,Hettinger County,38041
221,1215,1460,0.151369863,0.832191781,994,0.680821918,ND,Kidder County,38043
527,1645,2219,0.237494367,0.741324921,1118,0.503830554,ND,LaMoure County,38045
128,930,1076,0.118959108,0.864312268,802,0.74535316,ND,Logan County,38047
564,2364,3003,0.187812188,0.787212787,1800,0.599400599,ND,McHenry County,38049
261,1153,1455,0.179381443,0.792439863,892,0.613058419,ND,McIntosh County,38051
814,4482,5419,0.150212216,0.827089869,3668,0.676877653,ND,McKenzie County,38053
1230,4198,5536,0.222182081,0.758309249,2968,0.536127168,ND,McLean County,38055
704,3856,4675,0.150588235,0.824812834,3152,0.674224599,ND,Mercer County,38057
3872,12243,16619,0.232986341,0.736686925,8371,0.503700584,ND,Morton County,38059
1256,2824,4165,0.301560624,0.678031212,1568,0.376470588,ND,Mountrail County,38061
586,1141,1777,0.329769274,0.642093416,555,0.312324142,ND,Nelson County,38063
129,918,1066,0.121013133,0.861163227,789,0.740150094,ND,Oliver County,38065
786,2460,3331,0.235965176,0.738516962,1674,0.502551786,ND,Pembina County,38067
497,1585,2128,0.233552632,0.744830827,1088,0.511278195,ND,Pierce County,38069
1639,3577,5372,0.305100521,0.665860015,1938,0.360759494,ND,Ramsey County,38071
945,1418,2454,0.385085575,0.577832111,473,0.192746536,ND,Ransom County,38073
220,1065,1319,0.166793025,0.807429871,845,0.640636846,ND,Renville County,38075
2510,5072,7812,0.321300563,0.649257552,2562,0.327956989,ND,Richland County,38077
2482,1257,3804,0.652471083,0.33044164,-1225,-0.322029443,ND,Rolette County,38079
738,1266,2070,0.356521739,0.611594203,528,0.255072464,ND,Sargent County,38081
104,688,812,0.128078818,0.84729064,584,0.719211823,ND,Sheridan County,38083
804,258,1186,0.677908938,0.217537943,-546,-0.460370995,ND,Sioux County,38085
44,380,427,0.103044496,0.889929742,336,0.786885246,ND,Slope County,38087
2499,12110,15050,0.166046512,0.804651163,9611,0.638604651,ND,Stark County,38089
392,652,1088,0.360294118,0.599264706,260,0.238970588,ND,Steele County,38091
2676,6994,9959,0.268701677,0.702279345,4318,0.433577668,ND,Stutsman County,38093
317,830,1174,0.270017036,0.706984668,513,0.436967632,ND,Towner County,38095
1493,2522,4136,0.360976789,0.609767892,1029,0.248791103,ND,Traill County,38097
1333,3324,4783,0.278695379,0.694961321,1991,0.416265942,ND,Walsh County,38099
7293,19974,28246,0.258195851,0.707144374,12681,0.448948524,ND,Ward County,38101
442,1893,2374,0.186183656,0.797388374,1451,0.611204718,ND,Wells County,38103
2169,11739,14334,0.151318543,0.818961909,9570,0.667643365,ND,Williams County,38105
2156,9870,12145,0.177521614,0.812680115,7714,0.635158501,OH,Adams County,39001
14149,33116,48099,0.29416412,0.688496642,18967,0.394332523,OH,Allen County,39003
6541,19407,26405,0.247718235,0.734974437,12866,0.487256201,OH,Ashland County,39005
16497,26890,44237,0.372923119,0.607862197,10393,0.234939078,OH,Ashtabula County,39007
14772,10862,26120,0.565543645,0.415849923,-3910,-0.149693721,OH,Athens County,39009
4651,20798,25822,0.180117729,0.805437224,16147,0.625319495,OH,Auglaize County,39011
9138,23560,33141,0.275730968,0.710901904,14422,0.435170936,OH,Belmont County,39013
4380,16480,21139,0.207199962,0.779601684,12100,0.572401722,OH,Brown County,39015
69613,114392,186675,0.372910138,0.612786929,44779,0.239876791,OH,Butler County,39017
3251,10745,14233,0.228412843,0.754935713,7494,0.526522869,OH,Carroll County,39019
5062,14589,20003,0.253062041,0.729340599,9527,0.476278558,OH,Champaign County,39021
24076,39032,64351,0.3741356,0.606548461,14956,0.232412861,OH,Clark County,39023
34092,74570,110710,0.307939662,0.673561557,40478,0.365621895,OH,Clermont County,39025
4697,15488,20563,0.228419978,0.753197491,10791,0.524777513,OH,Clinton County,39027
13359,35726,49960,0.267393915,0.715092074,22367,0.447698159,OH,Columbiana County,39029
4125,12325,16768,0.246004294,0.735031011,8200,0.489026718,OH,Coshocton County,39031
4916,15436,20713,0.237338869,0.745232463,10520,0.507893593,OH,Crawford County,39033
416176,202699,627160,0.663588239,0.323201416,-213477,-0.340386823,OH,Cuyahoga County,39035
4731,22003,27160,0.174189985,0.810125184,17272,0.635935199,OH,Darke County,39037
5981,13038,19381,0.308601207,0.672720706,7057,0.364119498,OH,Defiance County,39039
57735,66356,126318,0.457060751,0.52530914,8621,0.068248389,OH,Delaware County,39041
17493,22160,40416,0.432823634,0.548297704,4667,0.11547407,OH,Erie County,39043
30634,49714,81564,0.375582365,0.609509097,19080,0.233926732,OH,Fairfield County,39045
2975,9473,12626,0.235624901,0.750277206,6498,0.514652305,OH,Fayette County,39047
409144,211237,632532,0.646835259,0.333954646,-197907,-0.312880613,OH,Franklin County,39049
6664,15731,22801,0.292267883,0.68992588,9067,0.397657997,OH,Fulton County,39051
2990,10645,13799,0.216682368,0.771432713,7655,0.554750344,OH,Gallia County,39053
21201,34143,56021,0.378447368,0.609467878,12942,0.23102051,OH,Geauga County,39055
34798,52072,88643,0.392563429,0.587434992,17274,0.194871563,OH,Greene County,39057
4577,13407,18264,0.250602278,0.734067017,8830,0.483464739,OH,Guernsey County,39059
246266,177886,430929,0.571476972,0.41279654,-68380,-0.158680432,OH,Hamilton County,39061
11757,26310,38771,0.303242114,0.678599985,14553,0.375357871,OH,Hancock County,39063
3062,9949,13247,0.231146675,0.751037971,6887,0.519891296,OH,Hardin County,39065
1768,5792,7663,0.23071904,0.755839749,4024,0.52512071,OH,Harrison County,39067
4062,10479,14788,0.274682175,0.708615093,6417,0.433932919,OH,Henry County,39069
3799,15678,19676,0.193077861,0.796808294,11879,0.603730433,OH,Highland County,39071
3880,9737,13855,0.280043306,0.70277878,5857,0.422735475,OH,Hocking County,39073
1994,10796,12978,0.153644629,0.831869317,8802,0.678224688,OH,Holmes County,39075
7759,18956,27190,0.285362266,0.697168076,11197,0.411805811,OH,Huron County,39077
3311,11309,14810,0.223565159,0.763605672,7998,0.540040513,OH,Jackson County,39079
10018,22828,33370,0.300209769,0.684087504,12810,0.383877734,OH,Jefferson County,39081
8589,22340,31459,0.273022029,0.710130646,13751,0.437108618,OH,Knox County,39083
55514,73278,130782,0.424477375,0.560306464,17764,0.13582909,OH,Lake County,39085
7489,20306,28123,0.266294492,0.722042456,12817,0.455747964,OH,Lawrence County,39087
33055,59514,94396,0.350173736,0.63047163,26459,0.280297894,OH,Licking County,39089
5055,17964,23409,0.215942586,0.767397155,12909,0.551454569,OH,Logan County,39091
75667,79520,157768,0.4796093,0.504031236,3853,0.024421936,OH,Lorain County,39093
115411,81763,200559,0.575446627,0.407675547,-33648,-0.16777108,OH,Lucas County,39095
5698,13835,19887,0.286518831,0.695680595,8137,0.409161764,OH,Madison County,39097
57641,59903,119190,0.483606007,0.502584109,2262,0.018978102,OH,Mahoning County,39099
8269,19023,27871,0.296688314,0.682537404,10754,0.38584909,OH,Marion County,39101
39800,64598,106041,0.375326525,0.609179468,24798,0.233852944,OH,Medina County,39103
2492,8316,10967,0.227227136,0.758274824,5824,0.531047689,OH,Meigs County,39105
3981,19145,23426,0.169939384,0.817254333,15164,0.647314949,OH,Mercer County,39107
15663,41371,58077,0.269693683,0.712347401,25708,0.442653718,OH,Miami County,39109
1605,5463,7159,0.224193323,0.763095404,3858,0.538902081,OH,Monroe County,39111
135064,129034,269164,0.50179073,0.479388031,-6030,-0.022402699,OH,Montgomery County,39113
1725,5041,6856,0.251604434,0.735268378,3316,0.483663944,OH,Morgan County,39115
4048,14077,18457,0.219320583,0.762691662,10029,0.543371079,OH,Morrow County,39117
11971,27867,40467,0.295821286,0.688635184,15896,0.392813898,OH,Muskingum County,39119
1170,5135,6348,0.184310019,0.808916194,3965,0.624606175,OH,Noble County,39121
9008,14628,24046,0.374615321,0.608334026,5620,0.233718706,OH,Ottawa County,39123
2213,7086,9484,0.233340363,0.7471531,4873,0.513812737,OH,Paulding County,39125
4098,12357,16676,0.245742384,0.741005037,8259,0.495262653,OH,Perry County,39127
7304,20593,28314,0.257964258,0.727308045,13289,0.469343788,OH,Pickaway County,39129
3110,9157,12424,0.250321958,0.737041211,6047,0.486719253,OH,Pike County,39131
35661,45990,83022,0.429536749,0.553949556,10329,0.124412806,OH,Portage County,39133
4493,17022,21840,0.205723443,0.779395604,12529,0.573672161,OH,Preble County,39135
3195,16412,19947,0.160174462,0.822780368,13217,0.662605906,OH,Putnam County,39137
17640,41472,59975,0.294122551,0.69148812,23832,0.397365569,OH,Richland County,39139
10557,22278,33365,0.316409411,0.66770568,11721,0.351296269,OH,Ross County,39141
10596,18896,30126,0.351722764,0.627232291,8300,0.275509527,OH,Sandusky County,39143
9080,22609,32051,0.283298493,0.705407008,13529,0.422108515,OH,Scioto County,39145
8266,17086,25848,0.319792634,0.661018261,8820,0.341225627,OH,Seneca County,39147
4465,20422,25293,0.176531056,0.807417072,15957,0.630886016,OH,Shelby County,39149
75904,111097,190093,0.39929929,0.584434987,35193,0.185135697,OH,Stark County,39151
151668,124833,281280,0.539206485,0.443803328,-26835,-0.095403157,OH,Summit County,39153
44519,55194,101152,0.44011982,0.545654065,10675,0.105534245,OH,Trumbull County,39155
12889,30458,44087,0.292353755,0.690861252,17569,0.398507497,OH,Tuscarawas County,39157
11141,21669,33535,0.332220069,0.646160728,10528,0.313940659,OH,Union County,39159
3067,11650,14994,0.204548486,0.776977458,8583,0.572428972,OH,Van Wert County,39161
1306,4525,5902,0.221280922,0.766689258,3219,0.545408336,OH,Vinton County,39163
46069,87988,136441,0.337647774,0.644879472,41919,0.307231697,OH,Warren County,39165
9243,22307,32031,0.288564203,0.696419094,13064,0.407854891,OH,Washington County,39167
16660,36759,54280,0.306927045,0.677210759,20099,0.370283714,OH,Wayne County,39169
4842,13452,18649,0.259638587,0.72132554,8610,0.461686954,OH,Williams County,39171
30617,35757,67651,0.452572763,0.528550945,5140,0.075978182,OH,Wood County,39173
2733,8462,11403,0.23967377,0.742085416,5729,0.502411646,OH,Wyandot County,39175
1387,5585,7108,0.195132245,0.785734384,4198,0.590602138,OK,Adair County,40001
232,1978,2262,0.102564103,0.874447392,1746,0.771883289,OK,Alfalfa County,40003
765,4557,5389,0.141955836,0.845611431,3792,0.703655595,OK,Atoka County,40005
190,1968,2178,0.087235996,0.903581267,1778,0.816345271,OK,Beaver County,40007
1048,6767,7948,0.131857071,0.85140916,5719,0.719552089,OK,Beckham County,40009
688,3136,3901,0.176365035,0.803896437,2448,0.627531402,OK,Blaine County,40011
3323,12344,15976,0.207999499,0.772658988,9021,0.564659489,OK,Bryan County,40013
2670,7013,9859,0.270818541,0.711329749,4343,0.440511208,OK,Caddo County,40015
16742,43550,61940,0.270293833,0.703099774,26808,0.432805941,OK,Canadian County,40017
4470,14699,19479,0.229477899,0.754607526,10229,0.525129627,OK,Carter County,40019
6027,11223,17714,0.340239359,0.63356667,5196,0.293327312,OK,Cherokee County,40021
1082,4698,5832,0.185528121,0.805555556,3616,0.620027435,OK,Choctaw County,40023
70,970,1054,0.066413662,0.920303605,900,0.853889943,OK,Cimarron County,40025
49827,66677,119778,0.41599459,0.556671509,16850,0.140676919,OK,Cleveland County,40027
374,2091,2524,0.148177496,0.82844691,1717,0.680269414,OK,Coal County,40029
13747,20905,35631,0.385815722,0.586708204,7158,0.200892481,OK,Comanche County,40031
393,2117,2572,0.152799378,0.823094868,1724,0.67029549,OK,Cotton County,40033
1217,4686,6032,0.201757294,0.776856764,3469,0.575099469,OK,Craig County,40035
6577,23294,30505,0.215603999,0.763612523,16717,0.548008523,OK,Creek County,40037
2369,8060,10691,0.221588252,0.753905154,5691,0.532316902,OK,Custer County,40039
3472,13557,17245,0.20133372,0.78614091,10085,0.58480719,OK,Delaware County,40041
214,2124,2359,0.090716405,0.900381518,1910,0.809665112,OK,Dewey County,40043
162,1688,1873,0.086492258,0.901227977,1526,0.814735718,OK,Ellis County,40045
4919,16970,22430,0.219304503,0.756576014,12051,0.537271511,OK,Garfield County,40047
1865,8878,10922,0.170756272,0.812854789,7013,0.642098517,OK,Garvin County,40049
4144,18538,23101,0.179386174,0.802476083,14394,0.62308991,OK,Grady County,40051
280,1916,2226,0.125786164,0.860736748,1636,0.734950584,OK,Grant County,40053
328,1605,1973,0.166244298,0.813482007,1277,0.647237709,OK,Greer County,40055
177,747,933,0.189710611,0.800643087,570,0.610932476,OK,Harmon County,40057
136,1327,1487,0.091459314,0.892400807,1191,0.800941493,OK,Harper County,40059
783,4165,5014,0.156162744,0.830674112,3382,0.674511368,OK,Haskell County,40061
919,3875,4857,0.189211447,0.797817583,2956,0.608606135,OK,Hughes County,40063
1646,6392,8221,0.200218951,0.777520983,4746,0.577302031,OK,Jackson County,40065
319,2026,2385,0.133752621,0.849475891,1707,0.71572327,OK,Jefferson County,40067
738,3441,4251,0.17360621,0.809456598,2703,0.635850388,OK,Johnston County,40069
4040,12834,17249,0.234216476,0.744043133,8794,0.509826657,OK,Kay County,40071
854,5521,6465,0.132095901,0.853982985,4667,0.721887084,OK,Kingfisher County,40073
699,2673,3427,0.203968486,0.779982492,1974,0.576014006,OK,Kiowa County,40075
762,3437,4249,0.179336314,0.808896211,2675,0.629559896,OK,Latimer County,40077
3299,15213,18805,0.175432066,0.808986972,11914,0.633554906,OK,Le Flore County,40079
2609,12013,14888,0.175241805,0.806891456,9404,0.631649651,OK,Lincoln County,40081
5455,15608,21574,0.252850654,0.723463428,10153,0.470612775,OK,Logan County,40083
711,3305,4076,0.174435721,0.810843965,2594,0.636408243,OK,Love County,40085
3582,15295,19236,0.18621335,0.795123726,11713,0.608910376,OK,McClain County,40087
1858,9485,11467,0.162030174,0.827156187,7627,0.665126014,OK,McCurtain County,40089
2031,6172,8335,0.243671266,0.740491902,4141,0.496820636,OK,McIntosh County,40091
320,3084,3467,0.092298817,0.889529853,2764,0.797231035,OK,Major County,40093
1100,4891,6064,0.181398417,0.806563325,3791,0.625164908,OK,Marshall County,40095
3581,12749,16626,0.215385541,0.766811019,9168,0.551425478,OK,Mayes County,40097
1156,4612,5894,0.196131659,0.782490668,3456,0.586359009,OK,Murray County,40099
8027,16526,25081,0.32004306,0.658905147,8499,0.338862087,OK,Muskogee County,40101
1003,3821,4938,0.203118672,0.773795059,2818,0.570676387,OK,Noble County,40103
712,3610,4391,0.162149852,0.822136188,2898,0.659986336,OK,Nowata County,40105
896,3058,4038,0.221892026,0.757305597,2162,0.535413571,OK,Okfuskee County,40107
141724,145050,294740,0.480844134,0.492128656,3326,0.011284522,OK,Oklahoma County,40109
4357,9668,14313,0.30440858,0.675469853,5311,0.371061273,OK,Okmulgee County,40111
6002,14121,20538,0.292238777,0.687554777,8119,0.395316,OK,Osage County,40113
2686,8545,11438,0.234831264,0.747071166,5859,0.512239902,OK,Ottawa County,40115
1363,5267,6786,0.200854701,0.776156793,3904,0.575302093,OK,Pawnee County,40117
10904,17813,29643,0.36784401,0.600917586,6909,0.233073576,OK,Payne County,40119
3768,13851,17924,0.210220933,0.772762776,10083,0.562541843,OK,Pittsburg County,40121
4117,10805,15320,0.268733681,0.705287206,6688,0.436553525,OK,Pontotoc County,40123
7275,20240,28185,0.258116019,0.718112471,12965,0.459996452,OK,Pottawatomie County,40125
668,4016,4739,0.140958008,0.847436168,3348,0.70647816,OK,Pushmataha County,40127
168,1629,1834,0.091603053,0.888222465,1461,0.796619411,OK,Roger Mills County,40129
9589,34031,44553,0.215226809,0.763831841,24442,0.548605032,OK,Rogers County,40131
2150,6011,8337,0.25788653,0.721002759,3861,0.463116229,OK,Seminole County,40133
3035,12113,15386,0.197257247,0.787274145,9078,0.590016898,OK,Sequoyah County,40135
3154,15560,19057,0.16550349,0.816497875,12406,0.650994385,OK,Stephens County,40137
894,4505,5521,0.161927187,0.815975367,3611,0.65404818,OK,Texas County,40139
597,2076,2708,0.220457903,0.76661743,1479,0.546159527,OK,Tillman County,40141
108996,150574,266678,0.40871763,0.564628503,41578,0.155910874,OK,Tulsa County,40143
8464,26165,35338,0.239515536,0.740421076,17701,0.500905541,OK,Wagoner County,40145
5790,17076,23501,0.246372495,0.726607378,11286,0.480234884,OK,Washington County,40147
598,4086,4777,0.125183169,0.855348545,3488,0.730165376,OK,Washita County,40149
591,2993,3678,0.160685155,0.813757477,2402,0.653072322,OK,Woods County,40151
1005,6611,7785,0.129094412,0.849197174,5606,0.720102762,OK,Woodward County,40153
2346,7352,9932,0.236206202,0.740233588,5006,0.504027386,OR,Baker County,41001
35827,14878,52799,0.678554518,0.28178564,-20949,-0.396768878,OR,Benton County,41003
139043,110509,255728,0.543714415,0.432134925,-28534,-0.111579491,OR,Clackamas County,41005
12916,10218,23764,0.543511193,0.429978118,-2698,-0.113533075,OR,Clatsop County,41007
13835,17150,32221,0.429378356,0.532261569,3315,0.102883213,OR,Columbia County,41009
14243,21829,37075,0.384167229,0.588779501,7586,0.204612272,OR,Coos County,41011
3801,11287,15448,0.246051269,0.730644744,7486,0.484593475,OR,Crook County,41013
12116,16969,29851,0.40588255,0.568456668,4853,0.162574118,OR,Curry County,41015
65962,55646,125234,0.526709999,0.444336203,-10316,-0.082373796,OR,Deschutes County,41017
19160,43298,64349,0.297751325,0.672862049,24138,0.375110724,OR,Douglas County,41019
324,834,1178,0.275042445,0.707979626,510,0.432937182,OR,Gilliam County,41021
929,3545,4596,0.202132289,0.771322889,2616,0.569190601,OR,Grant County,41023
894,3475,4481,0.199509038,0.775496541,2581,0.575987503,OR,Harney County,41025
8764,3955,13090,0.669518717,0.302139037,-4809,-0.367379679,OR,Hood River County,41027
59478,63869,126421,0.470475633,0.505208787,4391,0.034733154,OR,Jackson County,41029
4393,7189,11913,0.36875682,0.603458407,2796,0.234701587,OR,Jefferson County,41031
18451,31751,51641,0.357293623,0.614840921,13300,0.257547298,OR,Josephine County,41033
10388,25308,36556,0.284166758,0.692307692,14920,0.408140934,OR,Klamath County,41035
792,3470,4363,0.181526473,0.795324318,2678,0.613797846,OR,Lake County,41037
134366,80336,222253,0.604563268,0.361461938,-54030,-0.24310133,OR,Lane County,41039
17385,12460,30726,0.565807459,0.405519755,-4925,-0.160287704,OR,Lincoln County,41041
26512,43486,72640,0.364977974,0.598650881,16974,0.233672907,OR,Linn County,41043
3260,8187,11804,0.276177567,0.693578448,4927,0.417400881,OR,Malheur County,41045
80872,79002,165534,0.488552201,0.477255428,-1870,-0.011296773,OR,Marion County,41047
1371,3586,5118,0.267878077,0.700664322,2215,0.432786245,OR,Morrow County,41049
367249,82995,463659,0.792067015,0.179000084,-284254,-0.613066931,OR,Multnomah County,41051
22917,23732,48291,0.474560477,0.491437328,815,0.016876851,OR,Polk County,41053
260,921,1208,0.215231788,0.762417219,661,0.54718543,OR,Sherman County,41055
8066,8354,16888,0.477617243,0.494670772,288,0.017053529,OR,Tillamook County,41057
10499,21002,32539,0.322658963,0.645440856,10503,0.322781892,OR,Umatilla County,41059
4254,10298,14944,0.284662741,0.689105996,6044,0.404443255,OR,Union County,41061
1625,3404,5149,0.315595261,0.661099243,1779,0.345503981,OR,Wallowa County,41063
6604,7035,14130,0.467374381,0.497876858,431,0.030502477,OR,Wasco County,41065
209848,99035,320194,0.655377677,0.309296864,-110813,-0.346080814,OR,Washington County,41067
217,711,965,0.224870466,0.736787565,494,0.511917098,OR,Wheeler County,41069
27174,29551,58923,0.461178148,0.501518931,2377,0.040340784,OR,Yamhill County,41071
18207,37523,56540,0.322019809,0.66365405,19316,0.341634241,PI,Adams County,42001
429065,282324,722493,0.593867345,0.390763648,-146741,-0.203103698,PI,Allegheny County,42003
8457,27489,36370,0.232526808,0.755815232,19032,0.523288425,PI,Armstrong County,42005
38122,54759,94122,0.405027517,0.581787467,16637,0.17675995,PI,Beaver County,42007
4367,23025,27574,0.15837383,0.835025749,18658,0.676651918,PI,Bedford County,42009
92895,109736,205540,0.451955824,0.533891213,16841,0.08193539,PI,Berks County,42011
17636,45306,63595,0.277317399,0.712414498,27670,0.435097099,PI,Blair County,42013
8046,21600,30159,0.266786034,0.716204118,13554,0.449418084,PI,Bradford County,42015
204712,187367,396234,0.516644205,0.472869567,-17345,-0.043774638,PI,Bucks County,42017
37508,74359,113305,0.3310357,0.656272892,36851,0.325237192,PI,Butler County,42019
21730,48085,70574,0.307903761,0.681341571,26355,0.37343781,PI,Cambria County,42021
634,1771,2434,0.260476582,0.727608874,1137,0.467132293,PI,Cameron County,42023
11212,21984,33629,0.333402718,0.65372149,10772,0.320318772,PI,Carbon County,42025
40055,36372,77493,0.516885396,0.469358523,-3683,-0.047526873,PI,Centre County,42027
182372,128565,315753,0.577578044,0.407169528,-53807,-0.170408516,PI,Chester County,42029
4678,14578,19493,0.239983584,0.747858206,9900,0.507874622,PI,Clarion County,42031
9673,29203,39496,0.244910877,0.739391331,19530,0.494480454,PI,Clearfield County,42033
5502,11902,17625,0.312170213,0.67529078,6400,0.363120567,PI,Clinton County,42035
10532,20098,31171,0.337878156,0.644765968,9566,0.306887812,PI,Columbia County,42037
12924,28559,42004,0.307684982,0.679911437,15635,0.372226455,PI,Crawford County,42039
62245,77212,141595,0.439598856,0.545301741,14967,0.105702885,PI,Cumberland County,42041
78983,66408,147368,0.535957603,0.450627002,-12575,-0.085330601,PI,Dauphin County,42043
206423,118532,327931,0.629470834,0.361454086,-87891,-0.268016747,PI,Delaware County,42045
4522,12140,16906,0.267479002,0.718088253,7618,0.450609251,PI,Elk County,42047
68286,66869,137083,0.498136166,0.487799362,-1417,-0.010336803,PI,Erie County,42049
20444,41227,62139,0.329004329,0.663464169,20783,0.33445984,PI,Fayette County,42051
728,1882,2646,0.275132275,0.711262283,1154,0.436130008,PI,Forest County,42053
22422,57245,80783,0.277558397,0.708626815,34823,0.431068418,PI,Franklin County,42055
1085,6824,7977,0.136016046,0.855459446,5739,0.7194434,PI,Fulton County,42057
4911,12579,17669,0.277944422,0.71192484,7668,0.433980418,PI,Greene County,42059
5445,17061,22792,0.238899614,0.748552124,11616,0.50965251,PI,Huntingdon County,42061
12634,28089,41198,0.306665372,0.681804942,15455,0.37513957,PI,Indiana County,42063
4527,17960,22824,0.198343849,0.786890992,13433,0.588547143,PI,Jefferson County,42065
2253,9649,12043,0.187079631,0.801212323,7396,0.614132691,PI,Juniata County,42067
61991,52334,115410,0.537137163,0.453461572,-9657,-0.083675591,PI,Lackawanna County,42069
115847,160209,281375,0.411717459,0.569378943,44362,0.157661484,PI,Lancaster County,42071
15978,29597,46076,0.346774894,0.642351767,13619,0.295576873,PI,Lawrence County,42073
23932,46731,71858,0.333045729,0.650324251,22799,0.317278522,PI,Lebanon County,42075
98288,84259,184713,0.532111979,0.456161721,-14029,-0.075950258,PI,Lehigh County,42077
64873,86929,153321,0.423118816,0.566973865,22056,0.143855049,PI,Luzerne County,42079
16971,41462,59254,0.286411044,0.699733351,24491,0.413322307,PI,Lycoming County,42081
5098,14083,19466,0.261892531,0.723466557,8985,0.461574027,PI,McKean County,42083
21067,36143,57954,0.363512441,0.623649791,15076,0.26013735,PI,Mercer County,42085
4603,16670,21502,0.214073109,0.775276718,12067,0.561203609,PI,Mifflin County,42087
44060,38726,83829,0.525593768,0.461964237,-5334,-0.063629532,PI,Monroe County,42089
319511,185460,510157,0.626299355,0.363535147,-134051,-0.262764208,PI,Montgomery County,42091
3771,5844,9817,0.384129571,0.595293878,2073,0.211164307,PI,Montour County,42093
85087,83854,171399,0.496426467,0.489232726,-1233,-0.007193741,PI,Northampton County,42095
12677,28952,42283,0.299813164,0.684719627,16275,0.384906464,PI,Northumberland County,42097
5950,18293,24652,0.241359727,0.742049327,12343,0.500689599,PI,Perry County,42099
603790,132740,741377,0.814416957,0.179045209,-471050,-0.635371747,PI,Philadelphia County,42101
13019,19213,32554,0.399920133,0.59018861,6194,0.190268477,PI,Pike County,42103
1726,7239,9064,0.190423654,0.798654016,5513,0.608230362,PI,Potter County,42105
20727,48871,70603,0.293571095,0.692194383,28144,0.398623288,PI,Schuylkill County,42107
4910,13983,19140,0.256530825,0.730564263,9073,0.474033438,PI,Snyder County,42109
8654,31466,40543,0.213452384,0.776114249,22812,0.562661865,PI,Somerset County,42111
921,2619,3595,0.256189152,0.728511822,1698,0.47232267,PI,Sullivan County,42113
6236,15207,21752,0.286686282,0.699108128,8971,0.412421846,PI,Susquehanna County,42115
4955,15742,21075,0.235112693,0.746951364,10787,0.511838671,PI,Tioga County,42117
7475,12356,20115,0.371613224,0.614267959,4881,0.242654735,PI,Union County,42119
7585,18569,26528,0.285924306,0.699977382,10984,0.414053076,PI,Venango County,42121
6066,14237,20650,0.293753027,0.689443099,8171,0.395690073,PI,Warren County,42123
45088,72080,118478,0.380560104,0.608382991,26992,0.227822887,PI,Washington County,42125
9191,18637,28089,0.32720994,0.663498167,9446,0.336288227,PI,Wayne County,42127
72129,130218,205183,0.351534971,0.634643221,58089,0.28310825,PI,Westmoreland County,42129
4704,9936,14858,0.316597119,0.66873065,5232,0.352133531,PI,Wyoming County,42131
88114,146733,238471,0.369495662,0.615307522,58619,0.24581186,PI,York County,42133
18050,9745,28239,0.63918694,0.345090124,-8305,-0.294096816,RI,Bristol County,44001
49113,42001,92574,0.53052693,0.453701903,-7112,-0.076825026,RI,Kent County,44003
29486,15722,45901,0.642382519,0.342519771,-13764,-0.299862748,RI,Newport County,44005
165012,102551,271326,0.608168771,0.377962304,-62461,-0.230206467,RI,Providence County,44007
44549,29818,75587,0.589373834,0.394485824,-14731,-0.19488801,RI,Washington County,44009
4101,8215,12433,0.329847985,0.660741575,4114,0.33089359,SC,Abbeville County,45001
32275,51589,85185,0.378881258,0.605611317,19314,0.226730058,SC,Aiken County,45003
2718,835,3593,0.756470916,0.232396326,-1883,-0.524074589,SC,Allendale County,45005
27169,67565,96093,0.282736516,0.703120935,40396,0.420384419,SC,Anderson County,45007
4010,2417,6482,0.618636223,0.372878741,-1593,-0.245757482,SC,Bamberg County,45009
4720,5492,10321,0.457320027,0.532118981,772,0.074798954,SC,Barnwell County,45011
43419,53194,97835,0.443798232,0.543711351,9775,0.099913119,SC,Beaufort County,45013
45223,57397,104458,0.432929981,0.54947443,12174,0.116544448,SC,Berkeley County,45015
3905,4305,8291,0.470992643,0.519237728,400,0.048245085,SC,Calhoun County,45017
121485,93297,218857,0.555088482,0.426292054,-28188,-0.128796429,SC,Charleston County,45019
6983,18043,25270,0.276335576,0.714008706,11060,0.43767313,SC,Cherokee County,45021
6941,8660,15757,0.440502634,0.549597005,1719,0.109094371,SC,Chester County,45023
7431,11297,18876,0.393674507,0.598484848,3866,0.204810341,SC,Chesterfield County,45025
8250,8361,16733,0.49303771,0.499671308,111,0.006633598,SC,Clarendon County,45027
8602,10440,19283,0.446092413,0.541409532,1838,0.095317119,SC,Colleton County,45029
15220,16832,32417,0.46950674,0.519233735,1612,0.049726995,SC,Darlington County,45031
6436,6582,13101,0.491260209,0.502404397,146,0.011144187,SC,Dillon County,45033
33824,41913,77278,0.437692487,0.542366521,8089,0.104674034,SC,Dorchester County,45035
4953,8184,13304,0.372294047,0.615153337,3231,0.24285929,SC,Edgefield County,45037
7382,4625,12136,0.608272907,0.381097561,-2757,-0.227175346,SC,Fairfield County,45039
31153,32615,64510,0.482917377,0.50558053,1462,0.022663153,SC,Florence County,45041
15822,20487,36668,0.4314934,0.558716047,4665,0.127222646,SC,Georgetown County,45043
103030,150021,258155,0.399101315,0.581127617,46991,0.182026302,SC,Greenville County,45045
12145,19431,32006,0.379460101,0.607104918,7286,0.227644817,SC,Greenwood County,45047
5323,3906,9305,0.572058033,0.419774315,-1417,-0.152283718,SC,Hampton County,45049
59180,118821,179744,0.329246039,0.661056836,59641,0.331810798,SC,Horry County,45051
7185,7078,14394,0.499166319,0.491732666,-107,-0.007433653,SC,Jasper County,45053
12699,20471,33629,0.377620506,0.60873056,7772,0.231110054,SC,Kershaw County,45055
18937,30312,49868,0.37974252,0.60784471,11375,0.22810219,SC,Lancaster County,45057
10159,20004,30488,0.333213067,0.656127001,9845,0.322913933,SC,Laurens County,45059
5329,3008,8431,0.632072115,0.356778555,-2321,-0.275293559,SC,Lee County,45061
49301,92817,144568,0.34102291,0.642030048,43516,0.301007139,SC,Lexington County,45063
2687,2958,5697,0.471651747,0.519220642,271,0.047568896,SC,McCormick County,45065
8872,5711,14704,0.603373232,0.388397715,-3161,-0.214975517,SC,Marion County,45067
6290,5044,11446,0.549536956,0.440677966,-1246,-0.10885899,SC,Marlboro County,45069
6958,11443,18631,0.373463582,0.614191401,4485,0.240727819,SC,Newberry County,45071
10414,29698,40668,0.256073571,0.730254746,19284,0.474181174,SC,Oconee County,45073
27295,13603,41205,0.662419609,0.330129839,-13692,-0.332289771,SC,Orangeburg County,45075
13645,42907,57546,0.237114656,0.745612206,29262,0.50849755,SC,Pickens County,45077
132570,58313,193822,0.683978083,0.30085852,-74257,-0.383119563,SC,Richland County,45079
2963,6210,9274,0.319495363,0.669613975,3247,0.350118611,SC,Saluda County,45081
52926,93560,148655,0.356032424,0.629376745,40634,0.273344321,SC,Spartanburg County,45083
27379,21000,48920,0.559668847,0.429272281,-6379,-0.130396566,SC,Sumter County,45085
4935,8183,13257,0.372256167,0.617258807,3248,0.24500264,SC,Union County,45087
10289,5532,15985,0.643665937,0.346074445,-4757,-0.297591492,SC,Williamsburg County,45089
59008,82727,144050,0.409635543,0.574293648,23719,0.164658105,SC,York County,45091
317,1052,1405,0.225622776,0.748754448,735,0.523131673,SD,Aurora County,46003
2107,4808,7081,0.297556842,0.679000141,2701,0.381443299,SD,Beadle County,46005
466,694,1183,0.393913779,0.586644125,228,0.192730347,SD,Bennett County,46007
721,2235,3001,0.240253249,0.744751749,1514,0.5044985,SD,Bon Homme County,46009
6110,8000,14567,0.419441203,0.549186517,1890,0.129745315,SD,Brookings County,46011
6538,10580,17547,0.372599305,0.602952072,4042,0.230352767,SD,Brown County,46013
673,1750,2490,0.270281124,0.702811245,1077,0.43253012,SD,Brule County,46015
352,183,549,0.641165756,0.333333333,-169,-0.307832423,SD,Buffalo County,46017
939,3731,4802,0.195543524,0.77696793,2792,0.581424406,SD,Butte County,46019
117,747,873,0.134020619,0.855670103,630,0.721649485,SD,Campbell County,46021
1177,2552,3783,0.311128734,0.674596881,1375,0.363468147,SD,Charles Mix County,46023
437,1373,1850,0.236216216,0.742162162,936,0.505945946,SD,Clark County,46025
3083,2456,5698,0.541067041,0.431028431,-627,-0.11003861,SD,Clay County,46027
3837,8958,13161,0.291543196,0.680647367,5121,0.389104171,SD,Codington County,46029
622,647,1283,0.484801247,0.504286828,25,0.019485581,SD,Corson County,46031
1522,3852,5494,0.277029487,0.701128504,2330,0.424099017,SD,Custer County,46033
2648,5613,8454,0.313224509,0.663946061,2965,0.350721552,SD,Davison County,46035
1052,1869,2964,0.354925776,0.630566802,817,0.275641026,SD,Day County,46037
609,1699,2350,0.259148936,0.722978723,1090,0.463829787,SD,Deuel County,46039
1131,790,1966,0.575279756,0.401831129,-341,-0.173448627,SD,Dewey County,46041
216,1468,1707,0.126537786,0.859988284,1252,0.733450498,SD,Douglas County,46043
417,1538,1985,0.210075567,0.774811083,1121,0.564735516,SD,Edmunds County,46045
1053,2878,4042,0.260514597,0.712023751,1825,0.451509154,SD,Fall River County,46047
198,964,1182,0.16751269,0.815566836,766,0.648054146,SD,Faulk County,46049
1056,2618,3745,0.281975968,0.699065421,1562,0.417089453,SD,Grant County,46051
455,1771,2258,0.201505757,0.784322409,1316,0.582816652,SD,Gregory County,46053
105,1026,1137,0.092348285,0.90237467,921,0.810026385,SD,Haakon County,46055
647,2372,3083,0.209860525,0.769380474,1725,0.559519948,SD,Hamlin County,46057
373,1433,1836,0.203159041,0.780501089,1060,0.577342048,SD,Hand County,46059
557,1793,2388,0.233249581,0.750837521,1236,0.51758794,SD,Hanson County,46061
49,748,813,0.060270603,0.9200492,699,0.859778598,SD,Harding County,46063
2953,5522,8723,0.338530322,0.633039092,2569,0.29450877,SD,Hughes County,46065
762,2944,3767,0.202282984,0.781523759,2182,0.579240775,SD,Hutchinson County,46067
136,564,710,0.191549296,0.794366197,428,0.602816901,SD,Hyde County,46069
359,738,1115,0.321973094,0.661883408,379,0.339910314,SD,Jackson County,46071
270,721,1006,0.268389662,0.716699801,451,0.448310139,SD,Jerauld County,46073
90,498,599,0.150250417,0.831385643,408,0.681135225,SD,Jones County,46075
819,1904,2779,0.294710327,0.685138539,1085,0.390428212,SD,Kingsbury County,46077
2068,3681,5873,0.352119871,0.626766559,1613,0.274646688,SD,Lake County,46079
4537,8753,13828,0.328102401,0.632991033,4216,0.304888632,SD,Lawrence County,46081
11981,19617,32396,0.369829609,0.605537721,7636,0.235708112,SD,Lincoln County,46083
525,1042,1597,0.32874139,0.652473388,517,0.323731997,SD,Lyman County,46085
769,2068,2900,0.265172414,0.713103448,1299,0.447931034,SD,McCook County,46087
222,1075,1324,0.167673716,0.811933535,853,0.644259819,SD,McPherson County,46089
858,1287,2178,0.393939394,0.590909091,429,0.196969697,SD,Marshall County,46091
3285,9875,13670,0.240307242,0.722384784,6590,0.482077542,SD,Meade County,46093
298,449,769,0.387516255,0.583875163,151,0.196358908,SD,Mellette County,46095
320,787,1138,0.281195079,0.691564148,467,0.410369069,SD,Miner County,46097
40482,49249,92326,0.438468037,0.533425037,8767,0.094957,SD,Minnehaha County,46099
1179,1951,3206,0.367747973,0.608546475,772,0.240798503,SD,Moody County,46101
2829,297,3200,0.8840625,0.0928125,-2532,-0.79125,SD,Oglala Lakota County,46102
20606,35063,57518,0.358253069,0.609600473,14457,0.251347404,SD,Pennington County,46103
239,1401,1669,0.143199521,0.839424805,1162,0.696225285,SD,Perkins County,46105
227,1139,1380,0.164492754,0.825362319,912,0.660869565,SD,Potter County,46107
1828,2404,4307,0.424425354,0.558161133,576,0.133735779,SD,Roberts County,46109
257,905,1185,0.216877637,0.76371308,648,0.546835443,SD,Sanborn County,46111
998,2104,3163,0.315523237,0.665191274,1106,0.349668037,SD,Spink County,46115
421,1203,1652,0.254842615,0.728208232,782,0.473365617,SD,Stanley County,46117
185,726,930,0.198924731,0.780645161,541,0.58172043,SD,Sully County,46119
1963,532,2539,0.773139031,0.209531312,-1431,-0.56360772,SD,Todd County,46121
495,2161,2696,0.183605341,0.801557864,1666,0.617952522,SD,Tripp County,46123
1139,3290,4548,0.250439754,0.723394899,2151,0.472955145,SD,Turner County,46125
2725,5944,8855,0.307735743,0.671259176,3219,0.363523433,SD,Union County,46127
565,1966,2580,0.218992248,0.762015504,1401,0.543023256,SD,Walworth County,46129
4016,6581,10900,0.368440367,0.603761468,2565,0.235321101,SD,Yankton County,46135
481,404,906,0.530905077,0.445916115,-77,-0.084988962,SD,Ziebach County,46137
11733,23163,35527,0.330255862,0.651982999,11430,0.321727137,TN,Anderson County,47001
4443,14317,19039,0.233363097,0.751982772,9874,0.518619675,TN,Bedford County,47003
1526,5661,7250,0.210482759,0.780827586,4135,0.570344828,TN,Benton County,47005
971,4725,5758,0.168634943,0.82059743,3754,0.651962487,TN,Bledsoe County,47007
17834,47195,66306,0.268965101,0.711775707,29361,0.442810605,TN,Blount County,47009
9849,35194,45968,0.214257745,0.765619561,25345,0.551361817,TN,Bradley County,47011
2438,12330,14929,0.163306317,0.825909304,9892,0.662602987,TN,Campbell County,47013
1261,5190,6562,0.192167022,0.790917403,3929,0.598750381,TN,Cannon County,47015
2558,9194,11893,0.215084503,0.773059783,6636,0.55797528,TN,Carroll County,47017
4613,19873,24868,0.185499437,0.799139456,15260,0.613640019,TN,Carter County,47019
5457,14328,20091,0.271614156,0.713155144,8871,0.441540989,TN,Cheatham County,47021
1411,5951,7578,0.186196886,0.785299551,4540,0.599102666,TN,Chester County,47023
2201,10598,12935,0.170158485,0.819327406,8397,0.649168922,TN,Claiborne County,47025
735,2733,3506,0.209640616,0.779520821,1998,0.569880205,TN,Clay County,47027
2524,12182,14870,0.169737727,0.819233356,9658,0.649495629,TN,Cocke County,47029
5704,17863,24313,0.234607,0.734709826,12159,0.500102826,TN,Coffee County,47031
1382,4673,6114,0.2260386,0.764311416,3291,0.538272816,TN,Crockett County,47033
6728,25167,32307,0.208252082,0.778995264,18439,0.570743183,TN,Cumberland County,47035
197846,99415,308325,0.641680045,0.322435742,-98431,-0.319244304,TN,Davidson County,47037
904,4229,5250,0.172190476,0.80552381,3325,0.633333333,TN,Decatur County,47039
1747,6663,8501,0.205505235,0.783790142,4916,0.578284908,TN,DeKalb County,47041
6098,17619,24342,0.250513516,0.723810698,11521,0.473297182,TN,Dickson County,47043
3157,11766,15074,0.209433462,0.78054929,8609,0.571115829,TN,Dyer County,47045
7000,15661,22928,0.305303559,0.683051291,8661,0.377747732,TN,Fayette County,47047
1210,7403,8687,0.139288592,0.852192932,6193,0.71290434,TN,Fentress County,47049
4863,13977,19146,0.253995613,0.730021937,9114,0.476026324,TN,Franklin County,47051
5764,16245,22336,0.258058739,0.727301218,10481,0.469242479,TN,Gibson County,47053
3298,9783,13202,0.249810635,0.741024087,6485,0.491213453,TN,Giles County,47055
1463,8559,10123,0.144522375,0.845500346,7096,0.700977971,TN,Grainger County,47057
5183,22185,28057,0.184731083,0.790711765,17002,0.605980682,TN,Greene County,47059
985,4795,5844,0.168548939,0.820499658,3810,0.651950719,TN,Grundy County,47061
5497,18789,24606,0.223400797,0.763594245,13292,0.540193449,TN,Hamblen County,47063
75360,91991,170735,0.441385773,0.538794038,16631,0.097408264,TN,Hamilton County,47065
362,2372,2744,0.131924198,0.864431487,2010,0.732507289,TN,Hancock County,47067
4180,5760,10058,0.41558958,0.572678465,1580,0.157088884,TN,Hardeman County,47069
1774,9556,11534,0.153806138,0.828507023,7782,0.674700884,TN,Hardin County,47071
4069,20372,24776,0.164231514,0.822247336,16303,0.658015822,TN,Hawkins County,47073
4000,3338,7420,0.539083558,0.449865229,-662,-0.089218329,TN,Haywood County,47075
2092,9797,12020,0.174043261,0.815058236,7705,0.641014975,TN,Henderson County,47077
3547,11230,15034,0.235931888,0.746973527,7683,0.511041639,TN,Henry County,47079
2130,7577,9832,0.216639544,0.770646867,5447,0.554007323,TN,Hickman County,47081
869,2715,3681,0.236077153,0.737571312,1846,0.501494159,TN,Houston County,47083
2017,6116,8232,0.245019436,0.742954325,4099,0.497934888,TN,Humphreys County,47085
1133,4106,5308,0.213451394,0.773549359,2973,0.560097965,TN,Jackson County,47087
4645,18609,23562,0.197139462,0.789788643,13964,0.592649181,TN,Jefferson County,47089
1242,6466,7793,0.159373797,0.829718979,5224,0.670345182,TN,Johnson County,47091
91097,124339,219869,0.414323984,0.565514011,33242,0.151190027,TN,Knox County,47093
526,1492,2034,0.258603736,0.73352999,966,0.474926254,TN,Lake County,47095
3193,5672,8963,0.35624233,0.632823831,2479,0.276581502,TN,Lauderdale County,47097
3195,15334,18718,0.170691313,0.819211454,12139,0.648520141,TN,Lawrence County,47099
1068,4473,5604,0.190578158,0.798179872,3405,0.607601713,TN,Lewis County,47101
2909,12258,15575,0.186773676,0.787030498,9349,0.600256822,TN,Lincoln County,47103
6933,21684,29375,0.236017021,0.738178723,14751,0.502161702,TN,Loudon County,47105
4357,18175,22815,0.190970853,0.796625027,13818,0.605654175,TN,McMinn County,47107
1943,9085,11267,0.172450519,0.806337091,7142,0.633886571,TN,McNairy County,47109
1307,8095,9486,0.137781995,0.853362851,6788,0.715580856,TN,Macon County,47111
18309,23922,42847,0.42731113,0.558312134,5613,0.131001004,TN,Madison County,47113
3165,9873,13204,0.239700091,0.747727961,6708,0.50802787,TN,Marion County,47115
3603,11029,14862,0.242430359,0.742093931,7426,0.499663572,TN,Marshall County,47117
14386,31408,46561,0.308971027,0.674555959,17022,0.365584932,TN,Maury County,47119
1008,4464,5529,0.182311449,0.807379273,3456,0.625067824,TN,Meigs County,47121
3760,16742,20749,0.181213552,0.806882259,12982,0.625668707,TN,Monroe County,47123
32426,42156,76678,0.422885313,0.549779598,9730,0.126894285,TN,Montgomery County,47125
573,2888,3539,0.161910144,0.816049732,2315,0.654139587,TN,Moore County,47127
1161,6926,8218,0.141275249,0.842784132,5765,0.701508883,TN,Morgan County,47129
2589,10790,13521,0.19147992,0.798017898,8201,0.606537978,TN,Obion County,47131
2028,7911,10025,0.202294264,0.789127182,5883,0.586832918,TN,Overton County,47133
615,2775,3428,0.179404901,0.809509918,2160,0.630105018,TN,Perry County,47135
524,2373,2922,0.179329227,0.81211499,1849,0.632785763,TN,Pickett County,47137
1492,6792,8360,0.1784689,0.812440191,5300,0.633971292,TN,Polk County,47139
9154,23694,33481,0.273408799,0.707684956,14540,0.434276157,TN,Putnam County,47141
2363,11031,13608,0.173647854,0.810626102,8668,0.636978248,TN,Rhea County,47143
6034,19195,25914,0.23284711,0.740719302,13161,0.507872193,TN,Roane County,47145
8690,24535,33712,0.257771713,0.727782392,15845,0.470010679,TN,Robertson County,47147
59189,81373,143931,0.411231771,0.56536118,22184,0.154129409,TN,Rutherford County,47149
986,8004,9052,0.108926204,0.884224481,7018,0.775298277,TN,Scott County,47151
1295,5846,7239,0.178892112,0.807570106,4551,0.628677994,TN,Sequatchie County,47153
8695,33742,43574,0.199545601,0.774360857,25047,0.574815257,TN,Sevier County,47155
245208,129543,381858,0.642144462,0.339243907,-115665,-0.302900555,TN,Shelby County,47157
1798,7124,9035,0.199003874,0.788489209,5326,0.589485335,TN,Smith County,47159
1230,4942,6283,0.195766354,0.786566927,3712,0.590800573,TN,Stewart County,47161
17226,55774,74206,0.232137563,0.751610382,38548,0.519472819,TN,Sullivan County,47163
27630,63404,92529,0.298609085,0.685233819,35774,0.386624734,TN,Sumner County,47165
6832,20063,27291,0.25033894,0.735150782,13231,0.484811843,TN,Tipton County,47167
1011,2930,3991,0.25331997,0.734151842,1919,0.480831872,TN,Trousdale County,47169
1610,6593,8294,0.194116229,0.794911985,4983,0.600795756,TN,Unicoi County,47171
1248,6777,8096,0.154150198,0.83708004,5529,0.682929842,TN,Union County,47173
544,2338,2917,0.186492972,0.801508399,1794,0.615015427,TN,Van Buren County,47175
4126,12323,16692,0.24718428,0.738257848,8197,0.491073568,TN,Warren County,47177
18214,40120,59430,0.30647821,0.675079926,21906,0.368601716,TN,Washington County,47179
820,5795,6667,0.12299385,0.86920654,4975,0.746212689,TN,Wayne County,47181
3011,10382,13710,0.219620715,0.757257476,7371,0.537636761,TN,Weakley County,47183
2134,9587,11867,0.179826409,0.807870565,7453,0.628044156,TN,White County,47185
50161,86469,138932,0.361047131,0.622383612,36308,0.261336481,TN,Williamson County,47187
22197,50149,74092,0.299587,0.676847703,27952,0.377260703,TN,Wilson County,47189
3955,15110,19221,0.205764528,0.786119349,11155,0.58035482,TX,Anderson County,48001
850,4943,5863,0.144976974,0.843083746,4093,0.698106771,TX,Andrews County,48003
9136,25070,34628,0.263832737,0.723980594,15934,0.460147857,TX,Angelina County,48005
2916,9239,12289,0.237285377,0.751810562,6323,0.514525185,TX,Aransas County,48007
446,4300,4796,0.092994162,0.896580484,3854,0.803586322,TX,Archer County,48009
75,1035,1112,0.067446043,0.930755396,960,0.863309353,TX,Armstrong County,48011
5876,12039,18116,0.324354162,0.664550673,6163,0.340196511,TX,Atascosa County,48013
2951,11447,14554,0.202762127,0.78651917,8496,0.583757043,TX,Austin County,48015
409,1434,1859,0.220010758,0.771382464,1025,0.551371705,TX,Bailey County,48017
2505,10057,12712,0.197057898,0.791142228,7552,0.59408433,TX,Bandera County,48019
15452,20486,36709,0.420932196,0.55806478,5034,0.137132583,TX,Bastrop County,48021
183,1494,1700,0.107647059,0.878823529,1311,0.771176471,TX,Baylor County,48023
3288,6006,9414,0.349267049,0.637985978,2718,0.288718929,TX,Bee County,48025
57014,67893,127327,0.447776198,0.533217621,10879,0.085441422,TX,Bell County,48027
448452,308618,770571,0.581973627,0.400505599,-139834,-0.181468028,TX,Bexar County,48029
1911,5443,7441,0.25682032,0.731487703,3532,0.474667383,TX,Blanco County,48031
16,397,416,0.038461538,0.954326923,381,0.915865385,TX,Borden County,48033
1561,7469,9126,0.171049748,0.818430857,5908,0.647381109,TX,Bosque County,48035
10747,27116,38254,0.280937941,0.708840906,16369,0.427902964,TX,Bowie County,48037
62228,90433,154938,0.40163162,0.583672179,28205,0.182040558,TX,Brazoria County,48039
35349,47530,84943,0.416149653,0.559551699,12181,0.143402046,TX,Brazos County,48041
2258,2461,4822,0.468270427,0.510369141,203,0.042098714,TX,Brewster County,48043
78,639,725,0.107586207,0.88137931,561,0.773793103,TX,Briscoe County,48045
1470,998,2484,0.59178744,0.401771337,-472,-0.190016103,TX,Brooks County,48047
2107,13698,15963,0.131992733,0.858109378,11591,0.726116645,TX,Brown County,48049
1788,6743,8609,0.207689627,0.783250087,4955,0.57556046,TX,Burleson County,48051
5639,18767,24708,0.228225676,0.759551562,13128,0.531325886,TX,Burnet County,48053
6672,8031,14940,0.446586345,0.537550201,1359,0.090963855,TX,Caldwell County,48055
2148,5641,7856,0.273421589,0.718049898,3493,0.44462831,TX,Calhoun County,48057
734,6012,6832,0.107435597,0.879976581,5278,0.772540984,TX,Callahan County,48059
64063,49032,114159,0.561173451,0.429506215,-15031,-0.131667236,TX,Cameron County,48061
1394,3626,5058,0.275603005,0.716884144,2232,0.441281139,TX,Camp County,48063
297,2779,3116,0.095314506,0.891848524,2482,0.796534018,TX,Carson County,48065
2795,11033,13924,0.200732548,0.792372881,8238,0.591640333,TX,Cass County,48067
466,1602,2083,0.223715795,0.769083053,1136,0.545367259,TX,Castro County,48069
3997,17343,21641,0.184695716,0.801395499,13346,0.616699783,TX,Chambers County,48071
4210,15101,19508,0.215808899,0.77409268,10891,0.558283781,TX,Cherokee County,48073
310,1943,2279,0.136024572,0.852566915,1633,0.716542343,TX,Childress County,48075
614,5069,5741,0.106950009,0.882947222,4455,0.775997213,TX,Clay County,48077
177,809,1000,0.177,0.809,632,0.632,TX,Cochran County,48079
215,1565,1794,0.119843924,0.872352285,1350,0.752508361,TX,Coke County,48081
451,3640,4128,0.109253876,0.881782946,3189,0.77252907,TX,Coleman County,48083
230945,252318,492216,0.469194419,0.512616412,21373,0.043421994,TX,Collin County,48085
155,1048,1218,0.1272578,0.860426929,893,0.73316913,TX,Collingsworth County,48087
2403,7440,9912,0.242433414,0.750605327,5037,0.508171913,TX,Colorado County,48089
24826,62740,88863,0.279373868,0.706030631,37914,0.426656764,TX,Comal County,48091
852,5177,6084,0.140039448,0.850920447,4325,0.710880999,TX,Comanche County,48093
197,1058,1268,0.155362776,0.834384858,861,0.679022082,TX,Concho County,48095
3210,15596,18988,0.169054139,0.821360859,12386,0.65230672,TX,Cooke County,48097
7565,15438,23490,0.322051937,0.657215837,7873,0.3351639,TX,Coryell County,48099
113,543,665,0.169924812,0.816541353,430,0.646616541,TX,Cottle County,48101
241,1247,1503,0.160345975,0.829673985,1006,0.669328011,TX,Crane County,48103
344,1220,1574,0.218551461,0.775095299,876,0.556543837,TX,Crockett County,48105
527,1396,1953,0.26984127,0.714797747,869,0.444956477,TX,Crosby County,48107
438,415,864,0.506944444,0.480324074,-23,-0.02662037,TX,Culberson County,48109
197,1389,1609,0.122436296,0.863269111,1192,0.740832815,TX,Dallam County,48111
598576,307076,921638,0.649469748,0.333185047,-291500,-0.316284702,TX,Dallas County,48113
808,2951,3789,0.213248878,0.778833465,2143,0.565584587,TX,Dawson County,48115
1264,3294,4610,0.274186551,0.714533623,2030,0.440347072,TX,Deaf Smith County,48117
403,2162,2592,0.155478395,0.834104938,1759,0.678626543,TX,Delta County,48119
188695,222480,417964,0.451462327,0.532294647,33785,0.08083232,TX,Denton County,48121
1494,6567,8118,0.184035477,0.808943089,5073,0.624907613,TX,DeWitt County,48123
130,853,988,0.131578947,0.863360324,723,0.731781377,TX,Dickens County,48125
2264,1384,3666,0.61756683,0.377523186,-880,-0.240043644,TX,Dimmit County,48127
198,1438,1648,0.120145631,0.872572816,1240,0.752427184,TX,Donley County,48129
2575,2443,5053,0.509598258,0.483475163,-132,-0.026123095,TX,Duval County,48131
983,7237,8292,0.118547998,0.872768934,6254,0.754220936,TX,Eastland County,48133
11367,32697,44581,0.254974092,0.733429039,21330,0.478454947,TX,Ector County,48135
168,893,1066,0.157598499,0.837711069,725,0.68011257,TX,Edwards County,48137
27513,56651,85566,0.321541266,0.662073721,29138,0.340532454,TX,Ellis County,48139
178126,84331,267215,0.6666018,0.315592313,-93795,-0.351009487,TX,El Paso County,48141
2916,13684,16853,0.173025574,0.811962262,10768,0.638936688,TX,Erath County,48143
1899,4177,6133,0.309636393,0.681069623,2278,0.37143323,TX,Falls County,48145
2655,12171,15004,0.176952813,0.811183684,9516,0.634230872,TX,Fannin County,48147
2661,10171,12941,0.205625531,0.785951627,7510,0.580326095,TX,Fayette County,48149
352,1448,1826,0.192771084,0.792990142,1096,0.600219058,TX,Fisher County,48151
438,1584,2039,0.214811182,0.776851398,1146,0.562040216,TX,Floyd County,48153
99,445,551,0.179673321,0.807622505,346,0.627949183,TX,Foard County,48155
195191,157595,357833,0.545480713,0.440414942,-37596,-0.105065771,TX,Fort Bend County,48157
804,4161,5009,0.16051108,0.830704731,3357,0.670193651,TX,Franklin County,48159
1635,6991,8711,0.187693721,0.802548502,5356,0.614854781,TX,Freestone County,48161
2422,2823,5279,0.458799015,0.534760371,401,0.075961356,TX,Frio County,48163
576,5355,5995,0.096080067,0.89324437,4779,0.797164304,TX,Gaines County,48165
58842,93911,155060,0.379478911,0.605642977,35069,0.226164066,TX,Galveston County,48167
231,1413,1653,0.139745917,0.854809437,1182,0.715063521,TX,Garza County,48169
3176,12514,15846,0.20042913,0.789726114,9338,0.589296983,TX,Gillespie County,48171
39,611,653,0.059724349,0.93568147,572,0.875957121,TX,Glasscock County,48173
877,3085,3988,0.219909729,0.773570712,2208,0.553660983,TX,Goliad County,48175
1948,5627,7647,0.254740421,0.735844122,3679,0.481103701,TX,Gonzales County,48177
829,6840,7782,0.106527885,0.878951426,6011,0.772423542,TX,Gray County,48179
14506,44163,59439,0.24404852,0.742997022,29657,0.498948502,TX,Grayson County,48181
14796,32493,47982,0.308365637,0.677191447,17697,0.36882581,TX,Gregg County,48183
2833,9432,12413,0.22822847,0.759848546,6599,0.531620076,TX,Grimes County,48185
28805,47553,77592,0.371236725,0.612859573,18748,0.241622848,TX,Guadalupe County,48187
2279,7177,9584,0.237792154,0.748852254,4898,0.5110601,TX,Hale County,48189
168,995,1168,0.143835616,0.851883562,827,0.708047945,TX,Hall County,48191
641,3616,4349,0.147390205,0.831455507,2975,0.684065302,TX,Hamilton County,48193
166,1848,2046,0.08113392,0.903225806,1682,0.822091887,TX,Hansford County,48195
241,1330,1580,0.152531646,0.841772152,1089,0.689240506,TX,Hardeman County,48197
3474,23858,27635,0.12571015,0.863325493,20384,0.737615343,TX,Hardin County,48199
918193,700630,1640818,0.559594666,0.427000435,-217563,-0.13259423,TX,Harris County,48201
7908,21466,29710,0.266173006,0.722517671,13558,0.456344665,TX,Harrison County,48203
195,1868,2078,0.093840231,0.89894129,1673,0.805101059,TX,Hartley County,48205
353,1840,2214,0.159439928,0.831074977,1487,0.67163505,TX,Haskell County,48207
59524,47680,109357,0.544309006,0.436003182,-11844,-0.108305824,TX,Hays County,48209
206,1486,1720,0.119767442,0.863953488,1280,0.744186047,TX,Hemphill County,48211
7060,28911,36310,0.194436794,0.796226935,21851,0.60179014,TX,Henderson County,48213
128199,90527,220884,0.580390612,0.409839554,-37672,-0.170551058,TX,Hidalgo County,48215
2860,11926,14931,0.191547786,0.798740875,9066,0.607193088,TX,Hill County,48217
1482,6536,8095,0.183075973,0.807411983,5054,0.62433601,TX,Hockley County,48219
5641,26487,32580,0.173143033,0.812983425,20846,0.639840393,TX,Hood County,48221
3046,12719,15939,0.191103582,0.797979798,9673,0.606876216,TX,Hopkins County,48223
2314,7060,9437,0.245205044,0.748119106,4746,0.502914062,TX,Houston County,48225
2069,8054,10240,0.202050781,0.786523438,5985,0.584472656,TX,Howard County,48227
371,779,1165,0.318454936,0.668669528,408,0.350214592,TX,Hudspeth County,48229
8906,29163,38574,0.230880904,0.756027376,20257,0.525146472,TX,Hunt County,48231
965,7681,8771,0.110021662,0.875726827,6716,0.765705165,TX,Hutchinson County,48233
120,759,889,0.134983127,0.853768279,639,0.718785152,TX,Irion County,48235
331,3418,3782,0.087519831,0.903754627,3087,0.816234796,TX,Jack County,48237
1033,5231,6340,0.162933754,0.825078864,4198,0.66214511,TX,Jackson County,48239
2954,12542,15608,0.189261917,0.803562276,9588,0.614300359,TX,Jasper County,48241
501,784,1305,0.383908046,0.600766284,283,0.216858238,TX,Jeff Davis County,48243
46073,47570,94739,0.486315034,0.502116341,1497,0.015801307,TX,Jefferson County,48245
1197,833,2036,0.587917485,0.40913556,-364,-0.178781925,TX,Jim Hogg County,48247
6119,7453,13669,0.447655278,0.545248372,1334,0.097593094,TX,Jim Wells County,48249
16464,54628,72005,0.228650788,0.758669537,38164,0.530018749,TX,Johnson County,48251
999,5660,6741,0.148197597,0.839638036,4661,0.691440439,TX,Jones County,48253
1234,3968,5249,0.235092399,0.755953515,2734,0.520861116,TX,Karnes County,48255
18405,37624,56703,0.324586001,0.663527503,19219,0.338941502,TX,Kaufman County,48257
6020,20083,26438,0.227702549,0.759626295,14063,0.531923746,TX,Kendall County,48259
65,127,194,0.335051546,0.654639175,62,0.319587629,TX,Kenedy County,48261
47,411,462,0.101731602,0.88961039,364,0.787878788,TX,Kent County,48263
6510,20858,27738,0.234696085,0.751964814,14348,0.517268729,TX,Kerr County,48265
284,1987,2292,0.12390925,0.866928447,1703,0.743019197,TX,Kimble County,48267
8,151,159,0.050314465,0.949685535,143,0.899371069,TX,King County,48269
446,1144,1603,0.278228322,0.713661884,698,0.435433562,TX,Kinney County,48271
5359,5557,11041,0.485372702,0.50330586,198,0.017933158,TX,Kleberg County,48273
265,1180,1456,0.182005495,0.81043956,915,0.628434066,TX,Knox County,48275
4458,16760,21418,0.208142684,0.782519376,12302,0.574376693,TX,Lamar County,48277
840,3521,4408,0.190562613,0.798774955,2681,0.608212341,TX,Lamb County,48279
2144,8086,10399,0.206173671,0.777574767,5942,0.571401096,TX,Lampasas County,48281
1052,1335,2406,0.437240233,0.554862843,283,0.11762261,TX,La Salle County,48283
1333,8802,10195,0.130750368,0.863364394,7469,0.732614026,TX,Lavaca County,48285
1750,6255,8086,0.216423448,0.773559238,4505,0.55713579,TX,Lee County,48287
1072,7522,8672,0.123616236,0.867389299,6450,0.743773063,TX,Leon County,48289
5785,23302,29334,0.197211427,0.79436831,17517,0.597156883,TX,Liberty County,48291
2213,6789,9095,0.243320506,0.746454096,4576,0.50313359,TX,Limestone County,48293
131,1205,1353,0.096821877,0.890613452,1074,0.793791574,TX,Lipscomb County,48295
819,4199,5054,0.162049861,0.830827068,3380,0.668777206,TX,Live Oak County,48297
3167,9996,13278,0.238514837,0.752824221,6829,0.514309384,TX,Llano County,48299
4,60,66,0.060606061,0.909090909,56,0.848484848,TX,Loving County,48301
40017,78861,120771,0.331346101,0.652979606,38844,0.321633505,TX,Lubbock County,48303
428,1853,2293,0.186655037,0.808111644,1425,0.621456607,TX,Lynn County,48305
490,2904,3436,0.142607683,0.845168801,2414,0.702561118,TX,McCulloch County,48307
36688,59543,97771,0.375244193,0.609004715,22855,0.233760522,TX,McLennan County,48309
53,460,516,0.102713178,0.891472868,407,0.78875969,TX,McMullen County,48311
1088,4169,5297,0.205399283,0.787049273,3081,0.581649991,TX,Madison County,48313
1339,3470,4864,0.275287829,0.713404605,2131,0.438116776,TX,Marion County,48315
288,1857,2160,0.133333333,0.859722222,1569,0.726388889,TX,Martin County,48317
566,2108,2700,0.20962963,0.780740741,1542,0.571111111,TX,Mason County,48319
3733,9845,13726,0.271965613,0.717251931,6112,0.445286318,TX,Matagorda County,48321
8332,6881,15346,0.542942786,0.44839046,-1451,-0.094552326,TX,Maverick County,48323
6773,15642,22644,0.299107931,0.690779014,8869,0.391671083,TX,Medina County,48325
197,823,1028,0.191634241,0.800583658,626,0.608949416,TX,Menard County,48327
12329,45624,58856,0.209477368,0.775180101,33295,0.565702732,TX,Midland County,48329
2496,7984,10576,0.236006051,0.754916793,5488,0.518910741,TX,Milam County,48331
271,2217,2505,0.108183633,0.88502994,1946,0.776846307,TX,Mills County,48333
397,2170,2579,0.153935634,0.8414114,1773,0.687475766,TX,Mitchell County,48335
1097,8615,9814,0.111779091,0.877827593,7518,0.766048502,TX,Montague County,48337
74377,193382,271451,0.273997885,0.712401133,119005,0.438403248,TX,Montgomery County,48339
1062,4359,5508,0.192810458,0.791394336,3297,0.598583878,TX,Moore County,48341
1669,3872,5587,0.298729193,0.693037408,2203,0.394308216,TX,Morris County,48343
46,604,652,0.070552147,0.926380368,558,0.855828221,TX,Motley County,48345
9000,17378,26763,0.33628517,0.649329298,8378,0.313044128,TX,Nacogdoches County,48347
5101,13800,19121,0.26677475,0.721719575,8699,0.454944825,TX,Navarro County,48349
1175,4882,6096,0.192749344,0.800853018,3707,0.608103675,TX,Newton County,48351
1162,4131,5356,0.21695295,0.771284541,2969,0.554331591,TX,Nolan County,48353
60925,64617,127314,0.478541244,0.507540412,3692,0.028999167,TX,Nueces County,48355
302,2811,3155,0.095721078,0.890966719,2509,0.795245642,TX,Ochiltree County,48357
81,917,1009,0.080277502,0.908820614,836,0.828543112,TX,Oldham County,48359
6354,29170,35974,0.176627564,0.810863401,22816,0.634235837,TX,Orange County,48361
2178,10179,12485,0.174449339,0.815298358,8001,0.640849019,TX,Palo Pinto County,48363
2057,9322,11452,0.17961928,0.814006287,7265,0.634387007,TX,Panola County,48365
13017,62045,76128,0.170988335,0.815008932,49028,0.644020597,TX,Parker County,48367
488,2135,2650,0.184150943,0.805660377,1647,0.621509434,TX,Parmer County,48369
1382,3215,4668,0.296058269,0.688731791,1833,0.392673522,TX,Pecos County,48371
5387,18573,24181,0.222778214,0.768082379,13186,0.545304164,TX,Polk County,48373
9921,22820,33321,0.297740164,0.684853396,12899,0.387113232,TX,Potter County,48375
1463,721,2217,0.659900767,0.325214253,-742,-0.334686513,TX,Presidio County,48377
842,5155,6053,0.139104576,0.851643813,4313,0.712539237,TX,Rains County,48379
12750,50597,64412,0.197944482,0.785521331,37847,0.587576849,TX,Randall County,48381
172,942,1124,0.153024911,0.838078292,770,0.685053381,TX,Reagan County,48383
320,1643,1982,0.161453078,0.828960646,1323,0.667507568,TX,Real County,48385
1246,4517,5806,0.21460558,0.777988288,3271,0.563382708,TX,Red River County,48387
1395,2254,3687,0.378356387,0.61133713,859,0.232980743,TX,Reeves County,48389
1108,2210,3366,0.329174094,0.656565657,1102,0.327391563,TX,Refugio County,48391
17,529,550,0.030909091,0.961818182,512,0.930909091,TX,Roberts County,48393
2374,5646,8099,0.293122608,0.697123102,3272,0.404000494,TX,Robertson County,48395
18149,38842,57792,0.314040006,0.672099945,20693,0.358059939,TX,Rockwall County,48397
552,3807,4409,0.125198458,0.863461102,3255,0.738262645,TX,Runnels County,48399
4629,16534,21368,0.216632347,0.773773867,11905,0.55714152,TX,Rusk County,48401
669,4784,5487,0.121924549,0.871878987,4115,0.749954438,TX,Sabine County,48403
980,3007,4002,0.244877561,0.751374313,2027,0.506496752,TX,San Augustine County,48405
2337,10161,12638,0.1849185,0.804003798,7824,0.619085298,TX,San Jacinto County,48407
8988,16516,25888,0.347187886,0.637978986,7528,0.2907911,TX,San Patricio County,48409
287,2308,2602,0.110299769,0.887009992,2021,0.776710223,TX,San Saba County,48411
211,940,1159,0.182053494,0.811044003,729,0.628990509,TX,Schleicher County,48413
818,4983,5869,0.139376384,0.849037315,4165,0.70966093,TX,Scurry County,48415
130,1484,1628,0.07985258,0.911547912,1354,0.831695332,TX,Shackelford County,48417
2068,7975,10084,0.20507735,0.790856803,5907,0.585779453,TX,Shelby County,48419
91,886,991,0.091826438,0.894046418,795,0.80221998,TX,Sherman County,48421
29615,69080,100075,0.295928054,0.690282288,39465,0.394354234,TX,Smith County,48423
768,4099,4940,0.155465587,0.829757085,3331,0.674291498,TX,Somervell County,48425
9123,8247,17525,0.520570613,0.470584879,-876,-0.049985735,TX,Starr County,48427
397,3385,3800,0.104473684,0.890789474,2988,0.786315789,TX,Stephens County,48429
51,584,639,0.079812207,0.913928013,533,0.834115806,TX,Sterling County,48431
116,615,736,0.157608696,0.835597826,499,0.67798913,TX,Stonewall County,48433
322,1222,1557,0.206807964,0.784842646,900,0.578034682,TX,Sutton County,48435
478,1845,2355,0.202972399,0.78343949,1367,0.580467091,TX,Swisher County,48437
411567,409741,834697,0.493073534,0.490885914,-1826,-0.00218762,TX,Tarrant County,48439
14588,39547,55112,0.264697344,0.71757512,24959,0.452877776,TX,Taylor County,48441
119,334,458,0.259825328,0.729257642,215,0.469432314,TX,Terrell County,48443
757,2812,3612,0.209579181,0.778516058,2055,0.568936877,TX,Terry County,48445
82,806,899,0.091212458,0.896551724,724,0.805339266,TX,Throckmorton County,48447
2856,7570,10539,0.270993453,0.718284467,4714,0.447291014,TX,Titus County,48449
12106,32129,44891,0.269675436,0.71571139,20023,0.446035954,TX,Tom Green County,48451
435860,161337,610349,0.714116022,0.264335651,-274523,-0.449780372,TX,Travis County,48453
1323,5579,6938,0.190688959,0.804122225,4256,0.613433266,TX,Trinity County,48455
1403,8194,9660,0.145238095,0.848240166,6791,0.70300207,TX,Tyler County,48457
2877,15809,18887,0.152326997,0.837030762,12932,0.684703764,TX,Upshur County,48459
170,1178,1368,0.124269006,0.861111111,1008,0.736842105,TX,Upton County,48461
4073,6174,10342,0.39383098,0.596983175,2101,0.203152195,TX,Uvalde County,48463
6771,8284,15272,0.443360398,0.542430592,1513,0.099070194,TX,Val Verde County,48465
3516,22270,25994,0.135261984,0.85673617,18754,0.721474186,TX,Van Zandt County,48467
10371,23347,34205,0.303201286,0.682561029,12976,0.379359743,TX,Victoria County,48469
7875,15368,23641,0.333107737,0.650057104,7493,0.316949368,TX,Walker County,48471
8191,14260,22734,0.360297352,0.627254333,6069,0.266956981,TX,Waller County,48473
764,3241,4060,0.18817734,0.798275862,2477,0.610098522,TX,Ward County,48475
4261,12959,17418,0.24463199,0.744000459,8698,0.499368469,TX,Washington County,48477
41820,25898,68397,0.611430326,0.378642338,-15922,-0.232787988,TX,Webb County,48479
4694,11926,16761,0.280054889,0.711532725,7232,0.431477835,TX,Wharton County,48481
168,2159,2337,0.071887035,0.923833975,1991,0.851946941,TX,Wheeler County,48483
13161,32069,46030,0.285922225,0.696697806,18908,0.410775581,TX,Wichita County,48485
956,3524,4524,0.211317418,0.778956676,2568,0.567639257,TX,Wilbarger County,48487
3097,2437,5575,0.555515695,0.437130045,-660,-0.11838565,TX,Willacy County,48489
143795,139729,289312,0.497023974,0.482969942,-4066,-0.014054032,TX,Williamson County,48491
6350,18457,25006,0.253939055,0.738102855,12107,0.484163801,TX,Wilson County,48493
358,1753,2126,0.168391345,0.824553151,1395,0.656161806,TX,Winkler County,48495
4973,27032,32362,0.153667882,0.835300661,22059,0.681632779,TX,Wise County,48497
3509,19049,22779,0.154045393,0.836252689,15540,0.682207296,TX,Wood County,48499
419,2172,2633,0.159134068,0.824914546,1753,0.665780479,TX,Yoakum County,48501
1036,7112,8242,0.125697646,0.862897355,6076,0.737199709,TX,Young County,48503
1826,2033,3874,0.471347445,0.524780589,207,0.053433144,TX,Zapata County,48505
2864,1490,4379,0.654030601,0.340260333,-1374,-0.313770267,TX,Zavala County,48507
357,2695,3100,0.11516129,0.869354839,2338,0.754193548,UT,Beaver County,49001
4473,21548,27027,0.165501166,0.797276797,17075,0.631775632,UT,Box Elder County,49003
16650,38032,57571,0.289208108,0.660610377,21382,0.371402269,UT,Cache County,49005
2392,6693,9369,0.255310065,0.714377201,4301,0.459067136,UT,Carbon County,49007
111,496,619,0.179321486,0.801292407,385,0.621970921,UT,Daggett County,49009
57411,104135,169895,0.33792048,0.612937403,46724,0.275016922,UT,Davis County,49011
843,7513,8524,0.098897231,0.881393712,6670,0.782496481,UT,Duchesne County,49013
572,4207,4865,0.117574512,0.864748201,3635,0.74717369,UT,Emery County,49015
514,2158,2732,0.188140556,0.789897511,1644,0.601756955,UT,Garfield County,49017
2806,2248,5185,0.541176471,0.433558341,-558,-0.107618129,UT,Grand County,49019
4892,18989,24890,0.196544797,0.762916834,14097,0.566372037,UT,Iron County,49021
645,5087,5866,0.109955677,0.867200818,4442,0.757245141,UT,Juab County,49023
1083,2998,4180,0.259090909,0.71722488,1915,0.458133971,UT,Kane County,49025
624,5404,6160,0.101298701,0.877272727,4780,0.775974026,UT,Millard County,49027
1086,5181,6512,0.166769042,0.795608108,4095,0.628839066,UT,Morgan County,49029
86,773,871,0.098737084,0.887485649,687,0.788748565,UT,Piute County,49031
180,1157,1363,0.132061629,0.848862803,977,0.716801174,UT,Rich County,49033
289906,230174,541175,0.535697325,0.425322678,-59732,-0.110374648,UT,Salt Lake County,49035
3113,3535,6878,0.452602501,0.513957546,422,0.061355045,UT,San Juan County,49037
1794,10459,12631,0.14203151,0.828042119,8665,0.686010609,UT,Sanpete County,49039
1084,9052,10363,0.104602914,0.873492232,7968,0.768889318,UT,Sevier County,49041
15244,10252,26088,0.58432996,0.392977614,-4992,-0.191352346,UT,Summit County,49043
8943,21014,31518,0.283742623,0.666730122,12071,0.382987499,UT,Tooele County,49045
1663,13261,15307,0.108643104,0.866335663,11598,0.757692559,UT,Uintah County,49047
76033,192812,284480,0.267270107,0.677769966,116779,0.410499859,UT,Utah County,49049
6187,10795,17581,0.351913998,0.61401513,4608,0.262101132,UT,Wasatch County,49051
20530,67294,90476,0.226911004,0.743777355,46764,0.516866351,UT,Washington County,49053
365,1229,1621,0.225169648,0.758173967,864,0.533004318,UT,Wayne County,49055
40695,65949,111442,0.365167531,0.591778683,25254,0.226611152,UT,Weber County,49057
14967,6292,22022,0.679638543,0.285714286,-8675,-0.393924258,VT,Addison County,50001
12705,7114,20462,0.620907047,0.34766885,-5591,-0.273238198,VT,Bennington County,50003
9011,6551,16169,0.557301008,0.405158018,-2460,-0.15214299,VT,Caledonia County,50005
74961,21017,98915,0.757832482,0.212475358,-53944,-0.545357125,VT,Chittenden County,50007
1405,1773,3288,0.427311436,0.539233577,368,0.111922141,VT,Essex County,50009
13611,11274,25830,0.526945412,0.436469222,-2337,-0.09047619,VT,Franklin County,50011
2905,1810,4851,0.598845599,0.373118945,-1095,-0.225726654,VT,Grand Isle County,50013
10240,4163,14915,0.686557157,0.279114985,-6077,-0.407442172,VT,Lamoille County,50015
10304,6187,17122,0.601798855,0.361347973,-4117,-0.240450882,VT,Orange County,50017
7147,6512,14096,0.507023269,0.461975028,-635,-0.045048241,VT,Orleans County,50019
18230,14672,33970,0.536649985,0.431910509,-3558,-0.104739476,VT,Rutland County,50021
25191,8928,35307,0.713484578,0.252867703,-16263,-0.460616875,VT,Washington County,50023
18767,6440,26035,0.720837334,0.247359324,-12327,-0.47347801,VT,Windham County,50025
23376,9971,34446,0.678627417,0.289467572,-13405,-0.389159844,VT,Windsor County,50027
7578,9172,16962,0.446763353,0.540738121,1594,0.093974767,VA,Accomack County,51001
42466,20804,64657,0.656788901,0.321759438,-21662,-0.335029463,VA,Albemarle County,51003
2243,5859,8203,0.273436548,0.714250884,3616,0.440814336,VA,Alleghany County,51005
2411,5390,7893,0.305460535,0.682883568,2979,0.377423033,VA,Amelia County,51007
5672,11041,17005,0.333548956,0.649279624,5369,0.315730667,VA,Amherst County,51009
2418,6702,9268,0.260897713,0.723133362,4284,0.46223565,VA,Appomattox County,51011
105344,22318,130699,0.806004637,0.170758766,-83026,-0.63524587,VA,Arlington County,51013
10840,30714,42278,0.256398127,0.726477128,19874,0.470079001,VA,Augusta County,51015
646,1834,2501,0.258296681,0.733306677,1188,0.475009996,VA,Bath County,51017
12176,35600,48669,0.250179786,0.731471779,23424,0.481291993,VA,Bedford County,51019
532,2903,3479,0.152917505,0.834435183,2371,0.681517677,VA,Bland County,51021
5700,15099,21120,0.269886364,0.714914773,9399,0.445028409,VA,Botetourt County,51023
4552,3357,7948,0.572722698,0.422370408,-1195,-0.15035229,VA,Brunswick County,51025
1587,8311,9953,0.159449412,0.835024616,6724,0.675575203,VA,Buchanan County,51027
3471,4544,8126,0.427147428,0.559192715,1073,0.132045287,VA,Buckingham County,51029
8070,21245,29892,0.269971899,0.710725278,13175,0.440753379,VA,Campbell County,51031
7657,8336,16288,0.470100688,0.511787819,679,0.041687132,VA,Caroline County,51033
2842,12659,15651,0.181585841,0.808830107,9817,0.627244266,VA,Carroll County,51035
2624,1761,4441,0.590857915,0.396532313,-863,-0.194325602,VA,Charles City County,51036
2317,3815,6191,0.374252948,0.616217089,1498,0.241964141,VA,Charlotte County,51037
106935,93326,203884,0.524489416,0.457740676,-13609,-0.066748739,VA,Chesterfield County,51041
3920,5192,9337,0.419835065,0.556067259,1272,0.136232194,VA,Clarke County,51043
587,2536,3169,0.185231934,0.800252446,1949,0.615020511,VA,Craig County,51045
10617,16012,27116,0.39154005,0.590500074,5395,0.198960024,VA,Culpeper County,51047
2227,3019,5310,0.419397363,0.568549906,792,0.149152542,VA,Cumberland County,51049
1503,5748,7303,0.205805833,0.787073805,4245,0.581267972,VA,Dickenson County,51051
6224,8695,15092,0.412403923,0.576133051,2471,0.163729128,VA,Dinwiddie County,51053
3038,3075,6178,0.491744901,0.497733894,37,0.005988993,VA,Essex County,51057
419943,168401,600823,0.698946279,0.280283877,-251542,-0.418662401,VA,Fairfax County,51059
17565,25106,43661,0.402304116,0.575021186,7541,0.17271707,VA,Fauquier County,51061
3004,6225,9408,0.319302721,0.661670918,3221,0.342368197,VA,Floyd County,51063
7414,8155,15840,0.468055556,0.514835859,741,0.046780303,VA,Fluvanna County,51065
8381,20895,29702,0.282169551,0.703487981,12514,0.42131843,VA,Franklin County,51067
17207,30558,48703,0.353304725,0.627435682,13351,0.274130957,VA,Frederick County,51069
2156,6876,9176,0.234960767,0.74934612,4720,0.514385353,VA,Giles County,51071
6964,14875,22282,0.312539269,0.667579212,7911,0.355039943,VA,Gloucester County,51073
6685,9966,16950,0.39439528,0.587964602,3281,0.193569322,VA,Goochland County,51075
1535,6529,8131,0.188783667,0.802976264,4994,0.614192596,VA,Grayson County,51077
4163,6866,11311,0.368048802,0.607019715,2703,0.238970913,VA,Greene County,51079
2627,1914,4574,0.574333188,0.418452121,-713,-0.155881067,VA,Greensville County,51081
7666,10418,18248,0.420100833,0.570911881,2752,0.150811048,VA,Halifax County,51083
25307,44318,70967,0.356602364,0.624487438,19011,0.267885073,VA,Hanover County,51085
116572,63440,183152,0.636476806,0.346378964,-53132,-0.290097842,VA,Henrico County,51087
9127,16725,26105,0.349626508,0.640681862,7598,0.291055353,VA,Henry County,51089
417,1092,1533,0.272015656,0.712328767,675,0.440313112,VA,Highland County,51091
9399,13707,23456,0.400707708,0.584370737,4308,0.183663029,VA,Isle of Wight County,51093
25553,23153,49622,0.514953045,0.466587401,-2400,-0.048365644,VA,James City County,51095
1590,2450,4115,0.386391252,0.595382746,860,0.208991495,VA,King and Queen County,51097
5404,8446,14224,0.37992126,0.593785152,3042,0.213863892,VA,King George County,51099
3260,7320,10736,0.303651267,0.681818182,4060,0.378166915,VA,King William County,51101
3368,3697,7152,0.470917226,0.516918345,329,0.046001119,VA,Lancaster County,51103
1489,8365,9946,0.149708425,0.841041625,6876,0.691333199,VA,Lee County,51105
138372,82088,224862,0.61536409,0.365059459,-56284,-0.250304631,VA,Loudoun County,51107
8269,13294,21915,0.377321469,0.606616473,5025,0.229295003,VA,Louisa County,51109
2418,3537,6000,0.403,0.5895,1119,0.1865,VA,Lunenburg County,51111
2698,5300,8129,0.331898142,0.651986714,2602,0.320088572,VA,Madison County,51113
1825,3901,5826,0.313250944,0.669584621,2076,0.356333677,VA,Mathews County,51115
6803,9266,16204,0.419834609,0.571834115,2463,0.151999506,VA,Mecklenburg County,51117
2491,4196,6785,0.367133382,0.618422992,1705,0.251289609,VA,Middlesex County,51119
23218,20629,45037,0.515531674,0.458045607,-2589,-0.057486067,VA,Montgomery County,51121
4327,4812,9316,0.464469729,0.5165307,485,0.05206097,VA,Nelson County,51125
4621,9631,14463,0.319504944,0.665906105,5010,0.346401162,VA,New Kent County,51127
3667,2955,6732,0.544711824,0.438948307,-712,-0.105763518,VA,Northampton County,51131
3252,4485,7815,0.416122841,0.573896353,1233,0.157773512,VA,Northumberland County,51133
2971,4027,7078,0.419751342,0.56894603,1056,0.149194688,VA,Nottoway County,51135
7995,12426,20742,0.385449812,0.599074342,4431,0.21362453,VA,Orange County,51137
3007,9345,12514,0.240290874,0.746763625,6338,0.506472751,VA,Page County,51139
1954,7485,9534,0.204950703,0.785084959,5531,0.580134256,VA,Patrick County,51141
10115,23751,34227,0.295526923,0.693925848,13636,0.398398925,VA,Pittsylvania County,51143
5320,14055,19730,0.269640142,0.712366954,8735,0.442726812,VA,Powhatan County,51145
4973,4434,9574,0.519427616,0.463129309,-539,-0.056298308,VA,Prince Edward County,51147
7103,10103,17432,0.407469022,0.579566315,3000,0.172097292,VA,Prince George County,51149
142863,81222,228056,0.626438243,0.356149367,-61641,-0.270288876,VA,Prince William County,51153
4925,12127,17376,0.283436924,0.697916667,7202,0.414479742,VA,Pulaski County,51155
2096,2812,4978,0.421052632,0.564885496,716,0.143832865,VA,Rappahannock County,51157
1513,2547,4102,0.368844466,0.620916626,1034,0.25207216,VA,Richmond County,51159
21801,34268,57184,0.381243005,0.599258534,12467,0.218015529,VA,Roanoke County,51161
4086,8088,12373,0.33023519,0.653681403,4002,0.323446214,VA,Rockbridge County,51163
12644,30349,43811,0.288603319,0.692725571,17705,0.404122252,VA,Rockingham County,51165
2373,10879,13386,0.177274765,0.812714777,8506,0.635440012,VA,Russell County,51167
1692,9063,10869,0.155672095,0.83383936,7371,0.678167265,VA,Scott County,51169
6836,16463,23684,0.288633677,0.695110623,9627,0.406476946,VA,Shenandoah County,51171
3008,10963,14136,0.21279004,0.775537634,7955,0.562747595,VA,Smyth County,51173
3969,5730,9786,0.405579399,0.585530349,1761,0.17995095,VA,Southampton County,51175
34307,39411,75317,0.455501414,0.523268319,5104,0.067766905,VA,Spotsylvania County,51177
40245,37636,79625,0.505431711,0.47266562,-2609,-0.032766091,VA,Stafford County,51179
2397,2025,4471,0.536121673,0.45291881,-372,-0.083202863,VA,Surry County,51181
2827,2219,5088,0.555621069,0.436124214,-608,-0.119496855,VA,Sussex County,51183
3205,16731,20134,0.159183471,0.830982418,13526,0.671798947,VA,Tazewell County,51185
6603,14069,21147,0.312242871,0.665295314,7466,0.353052442,VA,Warren County,51187
6617,21679,28685,0.230678055,0.755760851,15062,0.525082796,VA,Washington County,51191
4501,5318,9933,0.453136011,0.535387094,817,0.082251082,VA,Westmoreland County,51193
3110,13366,16615,0.187180259,0.804453807,10256,0.617273548,VA,Wise County,51195
3143,11733,15072,0.208532378,0.778463376,8590,0.569930998,VA,Wythe County,51197
17683,20241,38787,0.455900173,0.521850104,2558,0.065949932,VA,York County,51199
66240,14544,82508,0.802831241,0.176273816,-51696,-0.626557425,VA,Alexandria city,51510
2313,5347,7806,0.29631053,0.684985908,3034,0.388675378,VA,Bristol city,51520
825,1863,2776,0.297190202,0.67110951,1038,0.373919308,VA,Buena Vista city,51530
20696,3094,24205,0.855029952,0.12782483,-17602,-0.727205123,VA,Charlottesville city,51540
66377,58180,127108,0.52220946,0.457720993,-8197,-0.064488467,VA,Chesapeake city,51550
2972,6007,9146,0.324950798,0.656789853,3035,0.331839055,VA,Colonial Heights city,51570
964,1580,2603,0.370341913,0.606991932,616,0.236650019,VA,Covington city,51580
11710,7428,19389,0.603950694,0.383103822,-4282,-0.220846872,VA,Danville city,51590
1612,754,2381,0.677026459,0.316673667,-858,-0.360352793,VA,Emporia city,51595
9174,4007,13483,0.680412371,0.297189053,-5167,-0.383223318,VA,Fairfax city,51600
7146,1490,8819,0.810295952,0.168953396,-5656,-0.641342556,VA,Falls Church city,51610
2525,1487,4058,0.622227698,0.366436668,-1038,-0.25579103,VA,Franklin city,51620
8517,4037,12862,0.662183175,0.313870316,-4480,-0.34831286,VA,Fredericksburg city,51630
777,1838,2638,0.294541319,0.696739955,1061,0.402198635,VA,Galax city,51640
46220,18430,65901,0.701355063,0.279661917,-27790,-0.421693146,VA,Hampton city,51650
11022,5591,17086,0.645089547,0.327226969,-5431,-0.317862578,VA,Harrisonburg city,51660
5430,4020,9608,0.565154038,0.418401332,-1410,-0.146752706,VA,Hopewell city,51670
1791,906,2762,0.648443157,0.328023172,-885,-0.320419986,VA,Lexington city,51678
18048,17097,36363,0.496328686,0.470175728,-951,-0.026152958,VA,Lynchburg city,51680
10356,6256,16968,0.610325318,0.368694012,-4100,-0.241631306,VA,Manassas city,51683
3992,1979,6087,0.655823887,0.325119106,-2013,-0.330704781,VA,Manassas Park city,51685
3766,2165,6013,0.626309662,0.360053218,-1601,-0.266256444,VA,Martinsville city,51690
53099,26377,81203,0.653904412,0.3248279,-26722,-0.329076512,VA,Newport News city,51700
64440,23443,89881,0.716947965,0.260822643,-40997,-0.456125321,VA,Norfolk city,51710
464,1109,1601,0.289818863,0.692692067,645,0.402873204,VA,Norton city,51720
12389,1584,14118,0.877532228,0.112197195,-10805,-0.765335033,VA,Petersburg city,51730
2054,5605,7857,0.261422935,0.713376607,3551,0.451953672,VA,Poquoson city,51735
30948,12755,44582,0.694181508,0.286102014,-18193,-0.408079494,VA,Portsmouth city,51740
3358,2786,6320,0.531329114,0.440822785,-572,-0.090506329,VA,Radford city,51750
92175,16603,111159,0.829217607,0.149362625,-75572,-0.679854983,VA,Richmond city,51760
26773,15607,43323,0.617985827,0.360247444,-11166,-0.257738384,VA,Roanoke city,51770
5148,7683,13051,0.394452532,0.588690522,2535,0.194237989,VA,Salem city,51775
6981,5695,12990,0.537413395,0.438414165,-1286,-0.09899923,VA,Staunton city,51790
28676,20082,49642,0.577656017,0.404536481,-8594,-0.173119536,VA,Suffolk city,51800
117393,105087,227561,0.515874864,0.461797057,-12306,-0.054077808,VA,Virginia Beach city,51810
4961,5507,10717,0.462909396,0.51385649,546,0.050947093,VA,Waynesboro city,51820
4790,1963,6883,0.695917478,0.285195409,-2827,-0.410722069,VA,Williamsburg city,51830
6610,5221,12106,0.546010243,0.431273749,-1389,-0.114736494,VA,Winchester city,51840
1814,3907,5836,0.310829335,0.669465387,2093,0.358636052,WA,Adams County,53001
4250,7319,11880,0.357744108,0.616077441,3069,0.258333333,WA,Asotin County,53003
38706,60365,102307,0.378331883,0.590037827,21659,0.211705944,WA,Benton County,53005
19349,22746,43025,0.449715282,0.528669378,3397,0.078954096,WA,Chelan County,53007
24721,23062,49025,0.504252932,0.470413055,-1659,-0.033839878,WA,Clallam County,53009
140324,126303,273451,0.513159579,0.46188531,-14021,-0.051274269,WA,Clark County,53011
668,1754,2482,0.269137792,0.706688155,1086,0.437550363,WA,Columbia County,53013
23938,34424,59969,0.399172906,0.574029915,10486,0.174857009,WA,Cowlitz County,53015
7811,12955,21183,0.368739083,0.61157532,5144,0.242836237,WA,Douglas County,53017
1486,2771,4351,0.341530683,0.636865088,1285,0.295334406,WA,Ferry County,53019
13340,18039,32226,0.413951468,0.559765407,4699,0.145813939,WA,Franklin County,53021
366,1069,1481,0.247130317,0.721809588,703,0.474679271,WA,Garfield County,53023
11819,24764,37475,0.315383589,0.660813876,12945,0.345430287,WA,Grant County,53025
17354,19877,38256,0.453628189,0.519578628,2523,0.065950439,WA,Grays Harbor County,53027
29213,22746,53539,0.545639627,0.424849175,-6467,-0.120790452,WA,Island County,53029
17204,6931,24658,0.697704599,0.281085246,-10273,-0.416619353,WA,Jefferson County,53031
907310,269167,1202570,0.754475831,0.223826472,-638143,-0.530649359,WA,King County,53033
90277,61563,157625,0.572732752,0.390566217,-28714,-0.182166534,WA,Kitsap County,53035
11246,14042,26113,0.430666718,0.537739823,2796,0.107073105,WA,Kittitas County,53037
5959,7237,13481,0.442029523,0.536829612,1278,0.094800089,WA,Klickitat County,53039
14520,29391,45077,0.322115491,0.652017659,14871,0.329902167,WA,Lewis County,53041
1713,5150,6993,0.244959245,0.736450736,3437,0.491491491,WA,Lincoln County,53043
17269,18710,37112,0.46532119,0.504149601,1441,0.038828411,WA,Mason County,53045
8900,11840,21152,0.420763994,0.559757943,2940,0.138993949,WA,Okanogan County,53047
6794,6953,14017,0.484697153,0.496040522,159,0.011343369,WA,Pacific County,53049
2593,5728,8513,0.304592975,0.672853283,3135,0.368260308,WA,Pend Oreille County,53051
249506,197730,460714,0.541563747,0.429181662,-51776,-0.112382085,WA,Pierce County,53053
9725,3057,13090,0.742933537,0.233537051,-6668,-0.509396486,WA,San Juan County,53055
38252,32762,72937,0.52445261,0.449182171,-5490,-0.075270439,WA,Skagit County,53057
3192,3885,7268,0.439185471,0.534534948,693,0.095349477,WA,Skamania County,53059
256728,166428,435582,0.589390746,0.382081904,-90300,-0.207308842,WA,Snohomish County,53061
135765,148576,293294,0.462897298,0.506577018,12811,0.043679721,WA,Spokane County,53063
7839,19808,28283,0.27716296,0.700350034,11969,0.423187074,WA,Stevens County,53065
96608,65277,166965,0.578612284,0.390962178,-31331,-0.187650106,WA,Thurston County,53067
1165,1741,2972,0.391991925,0.585800808,576,0.193808883,WA,Wahkiakum County,53069
13690,16400,31055,0.440830784,0.528095315,2710,0.087264531,WA,Walla Walla County,53071
83660,50489,137660,0.607729188,0.366765945,-33171,-0.240963243,WA,Whatcom County,53073
11184,9067,20964,0.533485976,0.432503339,-2117,-0.100982637,WA,Whitman County,53075
43179,50555,95713,0.451129941,0.528193662,7376,0.077063722,WA,Yakima County,53077
1457,5116,6677,0.218211772,0.766212371,3659,0.548000599,WV,Barbour County,54001
17186,33279,51535,0.3334821,0.645755312,16093,0.312273212,WV,Berkeley County,54003
2041,6816,9012,0.22647581,0.7563249,4775,0.52984909,WV,Boone County,54005
1457,4120,5664,0.257238701,0.72740113,2663,0.470162429,WV,Braxton County,54007
2947,7545,10656,0.276557808,0.708051802,4598,0.431493994,WV,Brooke County,54009
14994,21721,37360,0.40133833,0.581397216,6727,0.180058887,WV,Cabell County,54011
568,2364,2971,0.19118142,0.795691686,1796,0.604510266,WV,Calhoun County,54013
641,2679,3365,0.190490342,0.796136701,2038,0.60564636,WV,Clay County,54015
435,2619,3101,0.14027733,0.844566269,2184,0.704288939,WV,Doddridge County,54017
5063,11580,16862,0.300260942,0.686751275,6517,0.386490333,WV,Fayette County,54019
599,2012,2662,0.225018783,0.75582269,1413,0.530803907,WV,Gilmer County,54021
607,4871,5509,0.110183336,0.884189508,4264,0.774006172,WV,Grant County,54023
4655,10925,15850,0.293690852,0.689274448,6270,0.395583596,WV,Greenbrier County,54025
1939,8033,10086,0.192246679,0.796450525,6094,0.604203847,WV,Hampshire County,54027
3790,9806,13800,0.274637681,0.71057971,6016,0.435942029,WV,Hancock County,54029
1381,4859,6331,0.218132996,0.767493287,3478,0.549360291,WV,Hardy County,54031
9215,20683,30465,0.302478254,0.678910225,11468,0.376431971,WV,Harrison County,54033
3207,10093,13508,0.237414865,0.747186852,6886,0.509771987,WV,Jackson County,54035
12127,15033,27703,0.437750424,0.542648811,2906,0.104898386,WV,Jefferson County,54037
34344,46398,82244,0.417586693,0.564150576,12054,0.146563883,WV,Kanawha County,54039
1538,5782,7457,0.206249162,0.775378839,4244,0.569129677,WV,Lewis County,54041
1711,6012,7830,0.218518519,0.767816092,4301,0.549297573,WV,Lincoln County,54043
2333,10534,13026,0.179103332,0.808690312,8201,0.62958698,WV,Logan County,54045
1333,5148,6527,0.204228589,0.788723763,3815,0.584495174,WV,McDowell County,54047
8901,16300,25794,0.345080251,0.631929906,7399,0.286849655,WV,Marion County,54049
3455,10435,14080,0.245383523,0.741122159,6980,0.495738636,WV,Marshall County,54051
2526,8491,11203,0.225475319,0.757921985,5965,0.532446666,WV,Mason County,54053
5556,19237,25134,0.221055144,0.765377576,13681,0.544322432,WV,Mercer County,54055
2660,10040,12872,0.206650093,0.77998757,7380,0.573337477,WV,Mineral County,54057
1397,8544,10022,0.139393335,0.852524446,7147,0.713131112,WV,Mingo County,54059
20282,20803,42072,0.482078342,0.494461875,521,0.012383533,WV,Monongalia County,54061
1345,5068,6490,0.207241911,0.780893683,3723,0.573651772,WV,Monroe County,54063
1998,6537,8695,0.229787234,0.751811386,4539,0.522024152,WV,Morgan County,54065
2226,8279,10630,0.209407338,0.77883349,6053,0.569426152,WV,Nicholas County,54067
7223,12354,19898,0.363001307,0.620866419,5131,0.257865112,WV,Ohio County,54069
820,2782,3659,0.224104947,0.760317027,1962,0.53621208,WV,Pendleton County,54071
699,2742,3491,0.200229161,0.785448296,2043,0.585219135,WV,Pleasants County,54073
1047,2895,4008,0.261227545,0.722305389,1848,0.461077844,WV,Pocahontas County,54075
3163,11190,14572,0.217060115,0.767911062,8027,0.550850947,WV,Preston County,54077
7878,20034,28501,0.276411354,0.702922704,12156,0.42651135,WV,Putnam County,54079
7982,24673,33106,0.241104332,0.74527276,16691,0.504168429,WV,Raleigh County,54081
3362,8673,12200,0.27557377,0.710901639,5311,0.435327869,WV,Randolph County,54083
586,3649,4283,0.136819986,0.851972916,3063,0.71515293,WV,Ritchie County,54085
1455,4213,5763,0.25247267,0.73104286,2758,0.478570189,WV,Roane County,54087
1448,4074,5585,0.259265891,0.729453894,2626,0.470188004,WV,Summers County,54089
1796,5477,7383,0.243261547,0.741839361,3681,0.498577814,WV,Taylor County,54091
938,2841,3844,0.244016649,0.739073881,1903,0.495057232,WV,Tucker County,54093
631,3226,3922,0.160887302,0.822539521,2595,0.661652218,WV,Tyler County,54095
2256,7771,10221,0.220722043,0.760297427,5515,0.539575384,WV,Upshur County,54097
4088,12585,16947,0.241222635,0.742609311,8497,0.501386676,WV,Wayne County,54099
610,2759,3402,0.17930629,0.810993533,2149,0.631687243,WV,Webster County,54101
1539,4993,6667,0.230838458,0.748912554,3454,0.518074096,WV,Wetzel County,54103
466,2134,2653,0.175650207,0.804372409,1668,0.628722201,WV,Wirt County,54105
10926,27202,38762,0.281874,0.701769775,16276,0.419895774,WV,Wood County,54107
1157,7353,8592,0.134660149,0.855796089,6196,0.72113594,WV,Wyoming County,54109
4329,7362,11818,0.366305635,0.622948045,3033,0.25664241,WI,Adams County,55001
4801,3841,8757,0.548247117,0.438620532,-960,-0.109626584,WI,Ashland County,55003
9194,15803,25346,0.362739683,0.623490886,6609,0.260751203,WI,Barron County,55005
6147,4617,10880,0.564981618,0.424356618,-1530,-0.140625,WI,Bayfield County,55007
65511,75871,144017,0.454883798,0.52681975,10360,0.071935952,WI,Brown County,55009
2860,4834,7816,0.36591607,0.618474923,1974,0.252558854,WI,Buffalo County,55011
3569,6462,10141,0.351937679,0.637215265,2893,0.285277586,WI,Burnett County,55013
12116,18156,30774,0.393708975,0.589978553,6040,0.196269578,WI,Calumet County,55015
13983,21317,35938,0.389086761,0.593160443,7334,0.204073682,WI,Chippewa County,55017
4524,10002,14898,0.303664921,0.671365284,5478,0.367700362,WI,Clark County,55019
16410,16927,33869,0.484513862,0.499778559,517,0.015264696,WI,Columbia County,55021
3953,4620,8695,0.454629097,0.53133985,667,0.076710753,WI,Crawford County,55023
260185,78800,344791,0.754616565,0.228544249,-181385,-0.526072316,WI,Dane County,55025
16356,31355,48436,0.337682715,0.647349079,14999,0.309666364,WI,Dodge County,55027
10044,9752,20117,0.499279217,0.48476413,-292,-0.014515087,WI,Door County,55029
13218,10923,24677,0.535640475,0.442638895,-2295,-0.09300158,WI,Douglas County,55031
9897,13173,23524,0.420719265,0.559981296,3276,0.13926203,WI,Dunn County,55033
31620,25341,58275,0.542599743,0.434851995,-6279,-0.107747748,WI,Eau Claire County,55035
781,2133,2940,0.265646259,0.725510204,1352,0.459863946,WI,Florence County,55037
20588,35754,57251,0.359609439,0.624513109,15166,0.26490367,WI,Fond du Lac County,55039
1721,3285,5053,0.340589749,0.650108846,1564,0.309519098,WI,Forest County,55041
10998,14142,25608,0.429475164,0.552249297,3144,0.122774133,WI,Grant County,55043
10851,10169,21406,0.506913949,0.475053723,-682,-0.031860226,WI,Green County,55045
3344,7168,10671,0.313372692,0.671727111,3824,0.358354419,WI,Green Lake County,55047
7828,5909,13992,0.55946255,0.42231275,-1919,-0.1371498,WI,Iowa County,55049
1533,2438,4010,0.382294264,0.60798005,905,0.225685786,WI,Iron County,55051
4256,5791,10184,0.417910448,0.568637078,1535,0.15072663,WI,Jackson County,55053
19904,27208,47979,0.414848163,0.567081431,7304,0.152233269,WI,Jefferson County,55055
4746,8749,13709,0.34619593,0.638193887,4003,0.291997958,WI,Juneau County,55057
42193,44972,88738,0.475478375,0.506795285,2779,0.03131691,WI,Kenosha County,55059
3976,7927,12095,0.328730881,0.655394791,3951,0.326663911,WI,Kewaunee County,55061
37846,28684,67884,0.55750987,0.42254434,-9162,-0.134965529,WI,La Crosse County,55063
3647,4821,8555,0.426300409,0.563530099,1174,0.13722969,WI,Lafayette County,55065
3704,7330,11165,0.331751008,0.656515898,3626,0.32476489,WI,Langlade County,55067
6261,10017,16497,0.37952355,0.607201309,3756,0.22767776,WI,Lincoln County,55069
16818,27218,44829,0.375158937,0.607151621,10400,0.231992683,WI,Manitowoc County,55071
30808,44624,76751,0.401401936,0.58141262,13816,0.180010684,WI,Marathon County,55073
7366,15304,22979,0.320553549,0.665999391,7938,0.345445842,WI,Marinette County,55075
3239,5719,9065,0.357308329,0.630888031,2480,0.273579702,WI,Marquette County,55077
1303,278,1590,0.819496855,0.174842767,-1025,-0.644654088,WI,Menominee County,55078
317270,134357,458971,0.691263718,0.292735271,-182913,-0.398528447,WI,Milwaukee County,55079
8433,13775,22611,0.372960064,0.609216753,5342,0.236256689,WI,Monroe County,55081
6715,16226,23215,0.289252638,0.698944648,9511,0.409692009,WI,Oconto County,55083
10105,13671,24159,0.418270624,0.565876071,3566,0.147605447,WI,Oneida County,55085
47667,58385,108022,0.441271223,0.540491752,10718,0.099220529,WI,Outagamie County,55087
26517,33912,61486,0.431268907,0.551540188,7395,0.120271281,WI,Ozaukee County,55089
1489,2584,4144,0.359314672,0.623552124,1095,0.264237452,WI,Pepin County,55091
9839,12903,23458,0.419430471,0.550046892,3064,0.130616421,WI,Pierce County,55093
9370,16611,26371,0.35531455,0.629896477,7241,0.274581927,WI,Polk County,55095
20428,19299,40603,0.503115533,0.475309706,-1129,-0.027805827,WI,Portage County,55097
3032,5394,8546,0.354785865,0.631172478,2362,0.276386614,WI,Price County,55099
50159,54479,106451,0.471193319,0.511775371,4320,0.040582052,WI,Racine County,55101
3995,4871,9014,0.443199467,0.540381629,876,0.097182161,WI,Richland County,55103
46658,37138,85360,0.546602624,0.435074977,-9520,-0.111527648,WI,Rock County,55105
2517,5257,7886,0.319173218,0.666624398,2740,0.347451179,WI,Rusk County,55107
23190,32199,56707,0.408944222,0.567813497,9009,0.158869275,WI,St. Croix County,55109
18108,17493,36203,0.500179543,0.483192001,-615,-0.016987542,WI,Sauk County,55111
4498,5909,10510,0.427973359,0.562226451,1411,0.134253092,WI,Sawyer County,55113
7131,15173,22607,0.315433273,0.671163799,8042,0.355730526,WI,Shawano County,55115
27101,37609,66003,0.410602548,0.569807433,10508,0.159204885,WI,Sheboygan County,55117
2693,7655,10684,0.252059154,0.716491951,4962,0.464432797,WI,Taylor County,55119
6285,8833,15220,0.412943495,0.580354796,2548,0.167411301,WI,Trempealeau County,55121
7457,8218,15914,0.468581124,0.516400654,761,0.04781953,WI,Vernon County,55123
5903,9261,15369,0.384084846,0.602576615,3358,0.218491769,WI,Vilas County,55125
22789,33851,57600,0.395642361,0.587690972,11062,0.192048611,WI,Walworth County,55127
3867,6334,10378,0.372615147,0.610329543,2467,0.237714396,WI,Washburn County,55129
26650,60237,88070,0.302600204,0.683967299,33587,0.381367094,WI,Washington County,55131
103906,159649,267996,0.387714742,0.595714115,55743,0.207999373,WI,Waukesha County,55133
9703,18952,29130,0.333093031,0.650600755,9249,0.317507724,WI,Waupaca County,55135
4388,9016,13568,0.323408019,0.664504717,4628,0.341096698,WI,Waushara County,55137
44060,47796,94160,0.467926933,0.507604078,3736,0.039677145,WI,Winnebago County,55139
16365,24308,41298,0.396266163,0.588599932,7943,0.192333769,WI,Wood County,55141
9092,8579,18617,0.488370844,0.460815384,-513,-0.02755546,WY,Albany County,56001
788,4806,5752,0.136995828,0.835535466,4018,0.698539638,WY,Big Horn County,56003
1935,16975,19566,0.098896044,0.867576408,15040,0.768680364,WY,Campbell County,56005
1427,5014,6664,0.214135654,0.75240096,3587,0.538265306,WY,Carbon County,56007
861,5917,6970,0.123529412,0.84892396,5056,0.725394548,WY,Converse County,56009
378,3651,4119,0.091769847,0.886380189,3273,0.794610342,WY,Crook County,56011
5519,12007,18111,0.304731931,0.662967257,6488,0.358235327,WY,Fremont County,56013
1203,4878,6241,0.192757571,0.781605512,3675,0.588847941,WY,Goshen County,56015
482,1999,2577,0.187039193,0.775708188,1517,0.588668995,WY,Hot Springs County,56017
897,3881,4914,0.182539683,0.78978429,2984,0.607244607,WY,Johnson County,56019
15217,27891,44982,0.338290872,0.620048019,12674,0.281757147,WY,Laramie County,56021
1509,8643,10468,0.144153611,0.825659152,7134,0.681505541,WY,Lincoln County,56023
8530,25271,35202,0.242315778,0.717885347,16741,0.47556957,WY,Natrona County,56025
155,1118,1308,0.118501529,0.854740061,963,0.736238532,WY,Niobrara County,56027
3410,12813,16717,0.203983968,0.766465275,9403,0.562481306,WY,Park County,56029
890,3898,4923,0.180784075,0.791793622,3008,0.611009547,WY,Platte County,56031
4043,11843,16428,0.246104212,0.720903336,7800,0.474799123,WY,Sheridan County,56033
882,3957,4970,0.177464789,0.796177062,3075,0.618712274,WY,Sublette County,56035
3823,12229,16603,0.230259592,0.736553635,8406,0.506294043,WY,Sweetwater County,56037
9848,4341,14677,0.670981808,0.29576889,-5507,-0.375212918,WY,Teton County,56039
1591,7496,9402,0.169219315,0.797277175,5905,0.62805786,WY,Uinta County,56041
651,3245,4012,0.16226321,0.808823529,2594,0.646560319,WY,Washakie County,56043
360,3107,3542,0.101637493,0.877188029,2747,0.775550536,WY,Weston County,56045
